state,jurisdiction,clinton,trump,johnson,stein,other,totalvotes,,
AK,District 1,2573,3180,416,143,326,6638,,
AK,District 10,1808,6255,493,135,349,9040,,
AK,District 11,2142,6444,572,124,407,9689,,
AK,District 12,1928,6629,548,98,340,9543,,
AK,District 13,1684,4028,480,81,260,6533,,
AK,District 14,3043,5978,802,103,494,10420,,
AK,District 15,1828,2525,335,85,209,4982,,
AK,District 16,3294,3203,464,157,318,7436,,
AK,District 17,3290,2618,419,146,315,6788,,
AK,District 18,3909,2684,424,136,249,7402,,
AK,District 19,2669,1636,190,105,192,4792,,
AK,District 2,1585,3188,371,94,254,5492,,
AK,District 20,4151,2187,395,134,273,7140,,
AK,District 21,4224,3479,526,134,284,8647,,
AK,District 22,3270,4203,446,121,332,8372,,
AK,District 23,2894,3246,424,108,252,6924,,
AK,District 24,3578,4709,574,118,311,9290,,
AK,District 25,3378,3816,521,121,291,8127,,
AK,District 26,3374,4548,536,108,339,8905,,
AK,District 27,3729,4085,489,139,341,8783,,
AK,District 28,4749,5423,696,143,416,11427,,
AK,District 29,2101,6347,463,136,347,9394,,
AK,District 3,1241,5403,518,98,353,7613,,
AK,District 30,1816,6194,502,128,310,8950,,
AK,District 31,3466,5617,500,252,347,10182,,
AK,District 32,2701,3764,519,177,311,7472,,
AK,District 33,5978,2732,513,306,405,9934,,
AK,District 34,4220,3955,609,229,418,9431,,
AK,District 35,3749,4105,450,278,460,9042,,
AK,District 36,2693,4460,585,173,353,8264,,
AK,District 37,2421,1938,302,92,309,5062,,
AK,District 38,2758,1143,273,263,658,5095,,
AK,District 39,3142,1405,277,101,714,5639,,
AK,District 4,4162,4070,585,237,467,9521,,
AK,District 40,2338,1377,213,93,589,4610,,
AK,District 5,3187,3683,512,178,346,7906,,
AK,District 6,2536,4929,471,125,399,8460,,
AK,District 7,1510,5935,431,102,316,8294,,
AK,District 8,1218,6126,364,88,277,8073,,
AK,District 9,1843,6100,510,135,366,8954,,
AK,HD99 Fed Overseas Absentee,274,40,7,11,10,342,,
AL,Autauga,5936,18172,546,105,214,24973,,
AL,Baldwin,18458,72883,2464,456,954,95215,,
AL,Barbour,4871,5454,93,18,33,10469,,
AL,Bibb,1874,6738,124,17,66,8819,,
AL,Blount,2156,22859,338,89,146,25588,,
AL,Bullock,3530,1140,22,10,8,4710,,
AL,Butler,3726,4901,65,13,27,8732,,
AL,Calhoun,13242,32865,1116,262,379,47864,,
AL,Chambers,5784,7843,168,44,61,13900,,
AL,Cherokee,1547,8953,147,26,60,10733,,
AL,Chilton,2911,15081,228,52,97,18369,,
AL,Choctaw,3109,4106,52,6,19,7292,,
AL,Clarke,5749,7140,99,17,26,13031,,
AL,Clay,1237,5245,93,16,33,6624,,
AL,Cleburne,684,5764,90,20,35,6593,,
AL,Coffee,4221,15875,396,104,171,20767,,
AL,Colbert,7312,16746,511,107,239,24915,,
AL,Conecuh,3080,3420,51,10,24,6585,,
AL,Coosa,1782,3381,53,14,22,5252,,
AL,Covington,2387,13267,183,36,67,15940,,
AL,Crenshaw,1664,4513,65,14,11,6267,,
AL,Cullman,3798,32989,687,134,265,37873,,
AL,Dale,4413,13808,350,62,116,18749,,
AL,Dallas,12836,5789,96,24,47,18792,,
AL,DeKalb,3622,21405,458,152,189,25826,,
AL,Elmore,8443,27634,738,112,333,37260,,
AL,Escambia,4605,9935,188,37,80,14845,,
AL,Etowah,10442,32353,835,164,370,44164,,
AL,Fayette,1362,6712,109,24,42,8249,,
AL,Franklin,2197,9466,238,54,85,12040,,
AL,Geneva,1525,9994,149,24,66,11758,,
AL,Greene,4013,838,13,5,11,4880,,
AL,Hale,4775,3173,54,12,26,8040,,
AL,Henry,2292,5632,91,17,40,8072,,
AL,Houston,10664,30728,779,144,324,42639,,
AL,Jackson,3673,16672,393,90,156,20984,,
AL,Jefferson,156873,134768,6645,1554,4351,304191,,
AL,Lamar,1036,5823,62,15,30,6966,,
AL,Lauderdale,9952,27899,987,222,465,39525,,
AL,Lawrence,3627,10833,250,31,88,14829,,
AL,Lee,21230,34617,2030,364,950,59191,,
AL,Limestone,9468,29067,1055,202,502,40294,,
AL,Lowndes,4883,1751,32,11,7,6684,,
AL,Macon,7566,1431,69,49,25,9140,,
AL,Madison,62822,89520,6621,1254,3172,163389,,
AL,Marengo,5615,5233,104,13,29,10994,,
AL,Marion,1432,11274,181,26,71,12984,,
AL,Marshall,4917,29233,678,158,330,35316,,
AL,Mobile,72186,95116,3291,791,1353,172737,,
AL,Monroe,4332,5795,88,17,39,10271,,
AL,Montgomery,58916,34003,1486,490,983,95878,,
AL,Morgan,11254,37486,1168,218,518,50644,,
AL,Perry,3824,1407,23,6,18,5278,,
AL,Pickens,3972,5456,49,19,46,9542,,
AL,Pike,5056,7693,257,48,114,13168,,
AL,Randolph,2291,7705,124,19,48,10187,,
AL,Russell,9579,9210,281,68,118,19256,,
AL,Shelby,22977,73020,2965,480,1812,101254,,
AL,St Clair,5589,31651,684,130,346,38400,,
AL,Sumter,4746,1581,57,14,13,6411,,
AL,Talladega,12121,20614,411,106,155,33407,,
AL,Tallapoosa,5519,13594,233,52,88,19486,,
AL,Tuscaloosa,31762,47723,1873,390,952,82700,,
AL,Walker,4497,24266,455,95,159,29472,,
AL,Washington,2374,6042,73,22,22,8533,,
AL,Wilcox,4339,1742,22,7,13,6123,,
AL,Winston,872,9228,131,29,53,10313,,
AR,Arkansas,1939,3826,126,64,257,6212,,
AR,Ashley,2408,5338,156,34,147,8083,,
AR,Baxter,4169,14682,452,140,323,19766,,
AR,Benton,28005,60871,3871,949,3128,96824,,
AR,Boone,2926,12235,379,134,437,16111,,
AR,Bradley,1317,2164,73,16,83,3653,,
AR,Calhoun,639,1556,44,3,27,2269,,
AR,Carroll,3342,6786,238,210,182,10758,,
AR,Chicot,2350,1716,35,15,60,4176,,
AR,Clark,3620,4404,196,68,238,8526,,
AR,Clay,1199,3781,100,35,85,5200,,
AR,Cleburne,2101,9458,229,63,234,12085,,
AR,Cleveland,723,2462,59,8,102,3354,,
AR,Columbia,3140,5456,117,40,134,8887,,
AR,Conway,2656,4849,171,43,208,7927,,
AR,Craighead,10538,22892,1031,304,808,35573,,
AR,Crawford,4488,16686,581,173,522,22450,,
AR,Crittenden,8410,6964,242,96,240,15952,,
AR,Cross,1999,4584,105,24,162,6874,,
AR,Dallas,1165,1509,26,12,59,2771,,
AR,Desha,2228,1919,44,4,62,4257,,
AR,Drew,2365,3968,111,43,108,6595,,
AR,Faulkner,14629,29346,1675,511,1366,47527,,
AR,Franklin,1376,5039,177,34,144,6770,,
AR,Fulton,1067,3471,107,41,86,4772,,
AR,Garland,12311,26087,989,387,1031,40805,,
AR,Grant,1373,5725,177,30,140,7445,,
AR,Greene,3071,10720,404,97,308,14600,,
AR,Hempstead,2377,4401,106,22,143,7049,,
AR,Hot Spring,3149,8172,239,112,272,11944,,
AR,Howard,1351,3157,60,22,84,4674,,
AR,Independence,2881,9936,352,85,360,13614,,
AR,Izard,1113,4042,125,45,123,5448,,
AR,Jackson,1583,3267,111,26,169,5156,,
AR,Jefferson,15772,9250,296,157,419,25894,,
AR,Johnson,2427,6091,294,90,210,9112,,
AR,Lafayette,1032,1758,26,5,39,2860,,
AR,Lawrence,1263,4064,165,39,154,5685,,
AR,Lee,1735,1229,22,6,34,3026,,
AR,Lincoln,1252,2455,48,16,55,3826,,
AR,Little River,1397,3605,85,14,126,5227,,
AR,Logan,1715,5746,195,54,211,7921,,
AR,Lonoke,5664,19958,767,172,539,27100,,
AR,Madison,1588,4928,144,54,127,6841,,
AR,Marion,1434,5336,157,56,124,7107,,
AR,Miller,4273,11294,237,69,218,16091,,
AR,Mississippi,5670,7061,181,65,227,13204,,
AR,Monroe,1312,1489,37,9,37,2884,,
AR,Montgomery,748,2643,52,33,83,3559,,
AR,Nevada,1157,2000,35,6,48,3246,,
AR,Newton,699,2875,49,69,61,3753,,
AR,Ouachita,4321,5351,97,24,142,9935,,
AR,Perry,1049,3008,113,38,98,4306,,
AR,Phillips,4310,2446,62,20,115,6953,,
AR,Pike,685,3150,73,8,65,3981,,
AR,Poinsett,1880,5502,154,34,152,7722,,
AR,Polk,1212,6618,164,56,181,8231,,
AR,Pope,5000,16256,618,225,470,22569,,
AR,Prairie,814,2505,56,10,59,3444,,
AR,Pulaski,89574,61257,4328,1553,3064,159776,,
AR,Randolph,1425,4509,203,53,189,6379,,
AR,Saline,13256,35863,1466,326,1189,52100,,
AR,Scott,602,2731,83,25,69,3510,,
AR,Searcy,601,2955,68,18,86,3728,,
AR,Sebastian,12300,29127,1630,481,1099,44637,,
AR,Sevier,1075,3282,83,20,102,4562,,
AR,Sharp,1472,5407,155,49,166,7249,,
AR,St Francis,4031,3195,64,18,122,7430,,
AR,Stone,1203,4113,0,62,199,5577,,
AR,Union,5855,10456,275,70,238,16894,,
AR,Van Buren,1549,5382,182,53,173,7339,,
AR,Washington,33366,41476,3360,1316,2343,81861,,
AR,White,5170,21077,695,151,906,27999,,
AR,Woodruff,1118,1347,45,12,49,2571,,
AR,Yell,1480,4608,157,47,147,6439,,
AZ,Apache,17083,8240,1221,469,106,27119,,
AZ,Cochise,17450,28092,2394,993,455,49384,,
AZ,Coconino,32404,21108,2978,1414,536,58440,,
AZ,Gila,7003,14182,803,212,112,22312,,
AZ,Graham,3301,8025,497,116,195,12134,,
AZ,Greenlee,1092,1892,200,59,27,3270,,
AZ,LaPaz,1575,4003,211,73,15,5877,,
AZ,Maricopa,702907,747361,67043,19432,12355,1549098,,
AZ,Mohave,17455,58282,2639,740,230,79346,,
AZ,Navajo,16459,20577,1410,703,505,39654,,
AZ,Pima,224661,167428,15620,6200,2509,416418,,
AZ,Pinal,47892,72819,5010,1476,1057,128254,,
AZ,SantaCruz,11690,3897,432,221,47,16287,,
AZ,Yavapai,35590,71330,3996,1588,652,113156,,
AZ,Yuma,24605,225165,1873,649,124,252416,,
CA,Alameda,514842,95922,16906,17830,8766,654266,,
CA,Alpine,334,217,25,21,5,602,,
CA,Amador,6004,10485,804,227,214,17734,,
CA,Butte,41567,45144,4625,2594,1634,95564,,
CA,Calaveras,7944,13511,1104,424,153,23136,,
CA,Colusa,2661,3551,260,85,75,6632,,
CA,Contra Costa,319287,115956,16123,8637,6172,466175,,
CA,Del Norte,3485,5134,416,245,278,9558,,
CA,El Dorado,36404,49247,5027,1425,1488,93591,,
CA,Fresno,141341,124049,9246,4300,3383,282319,,
CA,Glenn,3065,5788,375,97,145,9470,,
CA,Humboldt,33200,18373,2163,3681,1829,59246,,
CA,Imperial,32667,12704,1221,745,754,48091,,
CA,Inyo,3155,4248,328,214,141,8086,,
CA,Kern,98689,129584,9359,2887,3644,244163,,
CA,Kings,13617,18093,1338,411,456,33915,,
CA,Lake,11496,10599,1095,930,376,24496,,
CA,Lassen,2224,7574,473,105,148,10524,,
CA,Los Angeles,2464364,769743,88968,76465,34768,3434308,,
CA,Madera,17029,23357,1558,644,524,43112,,
CA,Marin,108707,21771,4180,3109,1506,139273,,
CA,Mariposa,3122,5185,326,189,55,8877,,
CA,Mendocino,22079,10888,1331,2108,1071,37477,,
CA,Merced,37317,28725,2410,1209,1128,70789,,
CA,Modoc,877,2696,122,50,43,3788,,
CA,Mono,2773,2111,222,142,28,5276,,
CA,Monterey,89088,34895,4547,2823,2055,133408,,
CA,Napa,39199,17411,2551,1262,949,61372,,
CA,Nevada,26053,23365,2378,2189,950,54935,,
CA,Orange,609961,507148,46128,18068,16216,1197521,,
CA,Placer,73509,95138,9245,2501,2446,182839,,
CA,Plumas,3459,5420,411,186,200,9676,,
CA,Riverside,373695,333243,24089,11320,9044,751391,,
CA,Sacramento,326023,189789,24412,9846,9260,559330,,
CA,San Benito,12521,7841,815,364,383,21924,,
CA,San Bernardino,340833,271240,21050,10604,10256,653983,,
CA,San Diego,735476,477766,51663,22820,18675,1306400,,
CA,San Francisco,345084,37688,8883,9904,4233,405792,,
CA,San Joaquin,121124,88936,8049,3134,2923,224166,,
CA,San Luis Obispo,67107,56164,6473,2848,2417,135009,,
CA,San Mateo,237882,57929,9464,5102,4007,314384,,
CA,Santa Barbara,107142,56365,6748,3719,2812,176786,,
CA,Santa Clara,511684,144826,25325,12664,9210,703709,,
CA,Santa Cruz,95249,22438,4325,4485,2324,128821,,
CA,Shasta,22301,51778,3382,1300,1292,80053,,
CA,Sierra,601,1048,98,42,41,1830,,
CA,Siskiyou,7234,11341,875,575,467,20492,,
CA,Solano,102360,51920,6254,2771,2808,166113,,
CA,Sonoma,160435,51408,8987,7347,3076,231253,,
CA,Stanislaus,81647,78494,6662,2562,2781,172146,,
CA,Sutter,13076,18176,1437,382,452,33523,,
CA,Tehama,6809,15494,953,290,362,23908,,
CA,Trinity,2214,2812,302,239,119,5686,,
CA,Tulare,47585,58299,3800,1620,1030,112334,,
CA,Tuolumne,9123,14551,1101,384,370,25529,,
CA,Ventura,194402,132323,13679,6315,5007,351726,,
CA,Yolo,54752,20739,3346,1779,1474,82090,,
CA,Yuba,7910,13170,1063,438,417,22998,,
CO,Adams,96558,80082,9893,2703,4429,193665,,
CO,Alamosa,3189,3046,405,117,182,6939,,
CO,Arapahoe,159885,117053,16002,3829,6277,303046,,
CO,Archuleta,2500,4264,331,116,128,7339,,
CO,Baca,283,1753,51,18,48,2153,,
CO,Bent,590,1188,83,20,46,1927,,
CO,Boulder,132334,41396,8034,3733,2645,188142,,
CO,Broomfield,19731,14367,2174,497,920,37689,,
CO,Chaffee,4888,5391,537,198,236,11250,,
CO,Cheyenne,132,925,31,4,10,1102,,
CO,Clear Creek,2729,2575,365,118,79,5866,,
CO,Conejos,1771,1914,166,24,147,4022,,
CO,Costilla,1125,588,83,19,33,1848,,
CO,Crowley,339,1079,63,11,35,1527,,
CO,Custer,797,2061,141,24,43,3066,,
CO,Delta,4087,11655,475,255,318,16790,,
CO,Denver,244551,62690,14861,5580,4170,331852,,
CO,Dolores,242,944,31,13,25,1255,,
CO,Douglas,68657,102573,10212,1477,4580,187499,,
CO,Eagle,14099,8990,1368,423,343,25223,,
CO,El Paso,108010,179228,19877,4093,7759,318967,,
CO,Elbert,3134,11705,666,138,335,15978,,
CO,Fremont,5297,15122,890,243,421,21973,,
CO,Garfield,11271,13132,1135,468,464,26470,,
CO,Gilpin,1634,1566,193,122,61,3576,,
CO,Grand,3358,4494,487,128,121,8588,,
CO,Gunnison,5128,3289,595,249,151,9412,,
CO,Hinsdale,197,339,27,11,15,589,,
CO,Huerfano,1633,1883,151,48,68,3783,,
CO,Jackson,171,629,41,7,13,861,,
CO,Jefferson,160776,138177,18537,4579,6813,328882,,
CO,Kiowa,91,728,24,1,11,855,,
CO,Kit Carson,536,2967,95,16,88,3702,,
CO,La Plata,15525,12587,1878,665,495,31150,,
CO,Lake,1616,1270,173,78,62,3199,,
CO,Larimer,93113,83430,11510,3203,4724,195980,,
CO,Las Animas,2650,3710,251,62,120,6793,,
CO,Lincoln,409,1892,77,9,49,2436,,
CO,Logan,1851,7282,319,65,205,9722,,
CO,Mesa,21729,49779,3675,712,1758,77653,,
CO,Mineral,237,344,42,11,18,652,,
CO,Moffat,874,5305,179,31,136,6525,,
CO,Montezuma,3973,7853,544,235,253,12858,,
CO,Montrose,5466,14382,735,138,465,21186,,
CO,Morgan,3151,8145,350,80,234,11960,,
CO,Otero,2943,4928,320,57,204,8452,,
CO,Ouray,1697,1351,150,61,51,3310,,
CO,Park,3421,6135,509,169,183,10417,,
CO,Phillips,436,1791,60,9,36,2332,,
CO,Pitkin,7333,2550,374,186,80,10523,,
CO,Prowers,1186,3531,155,30,114,5016,,
CO,Pueblo,35875,36265,4072,942,1492,78646,,
CO,Rio Blanco,436,2791,118,16,89,3450,,
CO,Rio Grande,2001,3085,232,61,155,5534,,
CO,Routt,7600,5230,722,206,228,13986,,
CO,Saguache,1417,1147,92,129,50,2835,,
CO,San Juan,265,215,17,4,5,506,,
CO,San Miguel,2975,1033,154,128,39,4329,,
CO,Sedgwick,267,1015,28,21,33,1364,,
CO,Summit,9557,5100,1000,302,215,16174,,
CO,Teller,3603,9745,674,165,257,14444,,
CO,Washington,296,2299,82,11,45,2733,,
CO,Weld,46519,76651,7487,1353,3418,135428,,
CO,Yuma,726,3850,118,16,81,4791,,
CT,Andover,896,891,79,42,0,1908,,
CT,Ansonia,3532,3621,209,112,4,7478,,
CT,Ashford,1112,1042,108,63,7,2332,,
CT,Avon,5675,4390,361,141,35,10602,,
CT,Barkhamsted,905,1157,94,37,7,2200,,
CT,Beacon Falls,1146,2002,134,46,4,3332,,
CT,Berlin,4913,6210,326,142,10,11601,,
CT,Bethany,1580,1646,112,39,3,3380,,
CT,Bethel,4777,4575,318,152,24,9846,,
CT,Bethlehem,801,1405,59,47,5,2317,,
CT,Bloomfield,9637,1683,183,124,12,11639,,
CT,Bolton,1385,1436,120,49,12,3002,,
CT,Bozrah,536,764,58,31,1,1390,,
CT,Branford,8453,6585,344,201,22,15605,,
CT,Bridgeport,32035,6596,428,490,11,39560,,
CT,Bridgewater,518,571,33,17,2,1141,,
CT,Bristol,12499,12752,734,436,34,26455,,
CT,Brookfield,4216,4973,279,103,9,9580,,
CT,Brooklyn,1462,2052,141,60,5,3720,,
CT,Burlington,2352,2773,201,56,3,5385,,
CT,Canaan,357,203,23,9,0,592,,
CT,Canterbury,932,1609,111,50,10,2712,,
CT,Canton,3100,2601,187,100,14,6002,,
CT,Chaplin,434,624,55,34,4,1151,,
CT,Cheshire,7572,7105,538,189,17,15421,,
CT,Chester,1365,781,82,41,4,2273,,
CT,Clinton,3493,3415,176,98,9,7191,,
CT,Colchester,3898,4108,407,143,35,8591,,
CT,Colebrook,324,528,28,18,1,899,,
CT,Columbia,1558,1500,151,64,11,3284,,
CT,Cornwall,622,248,27,26,0,923,,
CT,Coventry,3083,3262,314,112,12,6783,,
CT,Cromwell,3808,3486,289,111,20,7714,,
CT,Danbury,16084,11626,749,379,11,28849,,
CT,Darien,5942,4625,586,80,32,11265,,
CT,Deep River,1412,1077,74,41,2,2606,,
CT,Derby,2332,2651,109,58,0,5150,,
CT,Durham,1898,2156,158,63,6,4281,,
CT,East Granby,1389,1371,149,36,5,2950,,
CT,East Haddam,2331,2487,164,95,10,5087,,
CT,East Hampton,3210,3648,277,88,22,7245,,
CT,East Hartford,13180,5213,406,233,15,19047,,
CT,East Haven,5425,6867,218,147,0,12657,,
CT,East Lyme,5512,4214,330,144,13,10213,,
CT,East Windsor,2441,2606,158,89,7,5301,,
CT,Eastford,367,513,48,21,13,962,,
CT,Easton,2203,2131,127,56,9,4526,,
CT,Ellington,3531,4199,322,115,35,8202,,
CT,Enfield,8646,9233,755,299,26,18959,,
CT,Essex,2291,1620,114,67,0,4092,,
CT,Fairfield,18041,12112,985,348,67,31553,,
CT,Farmington,7634,5977,477,185,30,14303,,
CT,Franklin,413,613,48,19,4,1097,,
CT,Glastonbury,11074,7533,726,247,45,19625,,
CT,Goshen,673,1064,61,25,0,1823,,
CT,Granby,3114,2967,292,115,21,6509,,
CT,Greenwich,17630,12215,1050,271,43,31209,,
CT,Griswold,1934,3012,232,89,9,5276,,
CT,Groton,8453,5936,662,272,34,15357,,
CT,Guilford,7864,4929,338,159,33,13323,,
CT,Haddam,2141,2556,171,93,9,4970,,
CT,Hamden,18962,7790,549,348,46,27695,,
CT,Hampton,484,509,37,27,2,1059,,
CT,Hartford,30375,2531,356,401,4,33667,,
CT,Hartland,349,804,48,31,6,1238,,
CT,Harwinton,1131,2107,117,41,11,3407,,
CT,Hebron,2627,2555,206,82,16,5486,,
CT,Kent,1081,559,45,27,4,1716,,
CT,Killingly,2491,3916,326,141,14,6888,,
CT,Killingworth,1895,1943,119,55,3,4015,,
CT,Lebanon,1583,2115,174,66,10,3948,,
CT,Ledyard,3336,3471,350,116,27,7300,,
CT,Lisbon,868,1175,83,52,3,2181,,
CT,Litchfield,2171,2434,180,66,8,4859,,
CT,Lyme,1019,567,73,28,4,1691,,
CT,Madison,5935,4500,334,120,24,10913,,
CT,Manchester,15109,8358,864,469,38,24838,,
CT,Mansfield,8309,2433,429,280,30,11481,,
CT,Marlborough,1687,1766,128,46,12,3639,,
CT,Meriden,12788,8660,635,348,12,22443,,
CT,Middlebury,1664,2630,148,45,8,4495,,
CT,Middlefield,1154,1361,78,38,5,2636,,
CT,Middletown,12959,7126,639,485,35,21244,,
CT,Milford,13598,13383,791,349,30,28151,,
CT,Monroe,4520,5922,353,95,18,10908,,
CT,Montville,3340,4156,327,149,0,7972,,
CT,Morris,510,838,41,24,5,1418,,
CT,Naugatuck,5219,7310,440,199,14,13182,,
CT,New Britain,15468,6055,406,381,18,22328,,
CT,New Canaan,5767,4541,511,81,66,10966,,
CT,New Fairfield,3071,4302,204,94,6,7677,,
CT,New Hartford,1654,2243,146,77,2,4122,,
CT,New Haven,35933,4540,493,618,104,41688,,
CT,New London,6305,1924,217,237,4,8687,,
CT,New Millford,6136,6865,433,214,20,13668,,
CT,Newington,8425,6557,479,213,17,15691,,
CT,Newtown,7448,7154,505,204,48,15359,,
CT,Norfolk,547,373,20,26,1,967,,
CT,North Branford,2933,4473,175,68,5,7654,,
CT,North Canaan,732,703,52,22,0,1509,,
CT,North Haven,5837,7268,323,146,15,13589,,
CT,North Stonington,1289,1560,124,51,6,3030,,
CT,Norwalk,24414,12324,968,490,36,38232,,
CT,Norwich,7453,5217,511,282,13,13476,,
CT,Old Lyme,2498,1999,142,63,7,4709,,
CT,Old Saybrook,3207,2784,133,85,16,6225,,
CT,Orange,3834,4221,216,86,10,8367,,
CT,Oxford,2398,4685,178,64,18,7343,,
CT,Plainfield,2177,3512,300,123,8,6120,,
CT,Plainville,3802,4492,254,151,4,8703,,
CT,Plymouth,1884,3767,113,42,4,5810,,
CT,Pomfret,1084,1014,94,33,7,2232,,
CT,Portland,2494,2491,186,82,0,5253,,
CT,Preston,978,1377,97,52,10,2514,,
CT,Prospect,1661,3701,156,58,9,5585,,
CT,Putnam,1562,1845,161,83,6,3657,,
CT,Redding,3127,2088,185,73,14,5487,,
CT,Ridgefield,7907,5680,516,146,47,14296,,
CT,Rocky Hill,5090,4331,304,105,8,9838,,
CT,Roxbury,765,638,55,16,0,1474,,
CT,Salem,1029,1182,98,34,3,2346,,
CT,Salisbury,1671,545,73,38,4,2331,,
CT,Scotland,310,518,58,22,1,909,,
CT,Seymour,3024,4824,227,117,14,8206,,
CT,Sharon,820,521,50,25,0,1416,,
CT,Shelton,8001,12051,520,264,21,20857,,
CT,Sherman,976,1065,67,28,1,2137,,
CT,Simsbury,7825,5357,598,161,43,13984,,
CT,Somers,2125,3350,163,46,10,5694,,
CT,South Windsor,7721,5557,498,166,12,13954,,
CT,Southbury,5013,6100,347,103,17,11580,,
CT,Southington,9890,12383,743,275,27,23318,,
CT,Sprague,535,864,78,30,2,1509,,
CT,Stafford,2286,3344,296,106,2,6034,,
CT,Stamford,34148,16222,1184,627,77,52258,,
CT,Sterling,478,1102,67,37,0,1684,,
CT,Stonington,5635,4081,302,144,11,10173,,
CT,Stratford,13729,10534,570,368,50,25251,,
CT,Suffield,3334,3789,307,111,17,7558,,
CT,Thomaston,1152,2616,152,50,1,3971,,
CT,Thompson,1579,2646,216,66,1,4508,,
CT,Tolland,4020,3908,399,146,26,8499,,
CT,Torrington,5713,8673,515,214,16,15131,,
CT,Trumbull,9299,9753,495,224,75,19846,,
CT,Union,188,277,22,9,0,496,,
CT,Vernon,7084,5666,553,237,19,13559,,
CT,Voluntown,431,862,63,29,0,1385,,
CT,Wallingford,10651,10940,716,301,28,22636,,
CT,Warren,352,451,35,16,4,858,,
CT,Washington,1242,738,57,41,4,2082,,
CT,Waterbury,19870,12837,612,391,9,33719,,
CT,Waterford,5233,4861,368,189,32,10683,,
CT,Watertown,3732,7730,300,122,0,11884,,
CT,West Hartford,23781,8055,993,445,72,33346,,
CT,West Haven,12477,7774,422,287,9,20969,,
CT,Westbrook,1699,1936,100,55,2,3792,,
CT,Weston,3807,1633,208,58,6,5712,,
CT,Westport,10655,4169,472,124,24,15444,,
CT,Wethersfield,7734,5794,447,194,53,14222,,
CT,Willington,1414,1373,127,82,0,2996,,
CT,Wilton,6055,3786,411,111,28,10391,,
CT,Winchester,1816,2903,146,122,7,4994,,
CT,Windham,5375,2564,271,183,10,8403,,
CT,Windsor,11370,4013,385,231,17,16016,,
CT,Windsor Locks,2789,3022,232,97,6,6146,,
CT,Wolcott,2575,6192,235,85,5,9092,,
CT,Woodbridge,3333,1814,120,73,13,5353,,
CT,Woodbury,2466,3171,149,79,65,5930,,
CT,Woodstock,1945,2281,187,67,6,4486,,
DC,Ward 1,37490,1066,645,675,757,40633,,
DC,Ward 2,28714,2304,853,351,1075,33297,,
DC,Ward 3,36475,3323,994,522,1481,42795,,
DC,Ward 4,37962,1358,376,732,742,41170,,
DC,Ward 5,37021,1141,504,628,808,40102,,
DC,Ward 6,45540,2506,1187,605,2071,51909,,
DC,Ward 7,31784,547,186,420,505,33442,,
DC,Ward 8,27844,478,161,325,419,29227,,
DE,Kent,33351,36991,2876,1042,NA,74260,,
DE,New Castle,162919,85525,9107,3956,NA,261507,,
DE,Sussex,39333,62611,2774,1105,NA,105823,,
FL,Alachua,75820,46834,4059,1507,351,128571,,
FL,Baker,2112,10294,169,30,29,12634,,
FL,Bay,21797,62194,2652,562,248,87453,,
FL,Bradford,2924,8913,177,47,37,12098,,
FL,Brevard,119679,181848,9451,2708,1066,314752,,
FL,Broward,553320,260951,11078,5094,1508,831951,,
FL,Calhoun,1241,4655,124,25,36,6081,,
FL,Charlotte,33445,60218,1946,567,198,96374,,
FL,Citrus,22789,54456,1724,480,251,79700,,
FL,Clay,27822,74963,2806,571,321,106483,,
FL,Collier,61085,105423,3263,747,271,170789,,
FL,Columbia,7601,20368,523,150,65,28707,,
FL,Desoto,3781,6778,166,53,40,10818,,
FL,Dixie,1270,5822,77,21,12,7202,,
FL,Duval,205704,211672,11318,2912,1089,432695,,
FL,Escambia,57461,88808,4612,1055,533,152469,,
FL,Flagler,22026,33850,1114,388,125,57503,,
FL,Franklin,1744,4125,95,33,18,6015,,
FL,Gadsden,15020,6728,229,78,58,22113,,
FL,Gilchrist,1458,6740,155,43,24,8420,,
FL,Glades,1271,2996,54,18,14,4353,,
FL,Gulf,1720,5329,195,27,22,7293,,
FL,Hamilton,1904,3443,79,17,17,5460,,
FL,Hardee,2149,5242,140,24,28,7583,,
FL,Hendry,4615,6195,207,52,46,11115,,
FL,Hernando,31795,58970,2051,710,270,93796,,
FL,Highlands,14937,29565,854,186,144,45686,,
FL,Hillsborough,307896,266870,15703,5032,2159,597660,,
FL,Holmes,853,7483,133,19,26,8514,,
FL,Indian River,29043,48620,1723,419,204,80009,,
FL,Jackson,6397,14257,266,60,61,21041,,
FL,Jefferson,3541,3930,110,42,22,7645,,
FL,Lafayette,518,2809,47,10,8,3392,,
FL,Lake,62838,102188,3985,975,476,170462,,
FL,Lee,124908,191551,6982,2127,852,326420,,
FL,Leon,92068,53821,4403,1366,474,152132,,
FL,Levy,5101,13775,358,102,59,19395,,
FL,Liberty,651,2543,76,17,9,3296,,
FL,Madison,3526,4851,95,22,11,8505,,
FL,Manatee,71224,101944,4177,1149,464,178958,,
FL,Marion,62041,107833,3365,972,489,174700,,
FL,Martin,30185,53204,1804,474,125,85792,,
FL,Miami-Dade,624146,333999,13219,5985,2855,980204,,
FL,Monroe,18971,21904,1131,398,74,42478,,
FL,Nassau,10869,34266,1195,188,89,46607,,
FL,Okaloosa,23780,71893,4171,611,400,100855,,
FL,Okeechobee,3959,9356,234,53,51,13653,,
FL,Orange,329894,195216,14483,4777,1905,546275,,
FL,Osceola,85458,50301,2811,1003,633,140206,,
FL,Palm Beach,374673,272402,10370,3723,1164,662332,,
FL,Pasco,90142,142101,6129,1908,859,241139,,
FL,Pinellas,233701,239201,13627,4611,1263,492403,,
FL,Polk,117433,157430,6810,1647,994,284314,,
FL,Putnam,10094,22138,597,219,69,33117,,
FL,Santa Rosa,18464,65339,3123,524,295,87745,,
FL,Sarasota,97870,124438,4715,1596,444,229063,,
FL,Seminole,105914,109443,6811,1974,754,224896,,
FL,St. Johns,43099,88684,3612,864,255,136514,,
FL,St. Lucie,66881,70289,2475,867,335,140847,,
FL,Sumter,22638,52730,971,201,125,76665,,
FL,Suwannee,3964,14287,309,81,53,18694,,
FL,Taylor,2152,6930,151,33,24,9290,,
FL,Union,1014,4568,90,12,10,5694,,
FL,Volusia,109091,143007,6111,2003,657,260869,,
FL,Wakulla,4348,10512,378,66,47,15351,,
FL,Walton,6876,25756,783,142,80,33637,,
FL,Washington,2264,8637,192,22,41,11156,,
GA,Appling,1434,5494,77,NA,NA,7005,,
GA,Atkinson,697,1878,35,NA,NA,2610,,
GA,Bacon,608,3364,47,NA,NA,4019,,
GA,Baker,650,775,15,NA,NA,1440,,
GA,Baldwin,7970,7697,419,NA,NA,16086,,
GA,Banks,684,6134,132,NA,NA,6950,,
GA,Barrow,6580,21108,1143,NA,NA,28831,,
GA,Bartow,8212,29911,1183,NA,NA,39306,,
GA,Ben Hill,2101,3739,91,NA,NA,5931,,
GA,Berrien,1047,5422,115,NA,NA,6584,,
GA,Bibb,36787,24043,1447,NA,NA,62277,,
GA,Bleckley,1101,3719,123,NA,NA,4943,,
GA,Brantley,619,5567,106,NA,NA,6292,,
GA,Brooks,2528,3701,89,NA,NA,6318,,
GA,Bryan,4014,10529,542,NA,NA,15085,,
GA,Bulloch,9261,15097,890,NA,NA,25248,,
GA,Burke,4731,4491,129,NA,NA,9351,,
GA,Butts,2566,6717,194,NA,NA,9477,,
GA,Calhoun,1179,830,16,NA,NA,2025,,
GA,Camden,5930,12310,629,NA,NA,18869,,
GA,Candler,1026,2664,73,NA,NA,3763,,
GA,Carroll,12464,30029,1346,NA,NA,43839,,
GA,Catoosa,4771,20876,881,NA,NA,26528,,
GA,Charlton,1004,2951,54,NA,NA,4009,,
GA,Chatham,62290,45688,3503,NA,NA,111481,,
GA,Chattahoochee,594,751,45,NA,NA,1390,,
GA,Chattooga,1613,6462,177,NA,NA,8252,,
GA,Cherokee,25231,80649,5015,NA,NA,110895,,
GA,Clarke,29603,12717,2019,NA,NA,44339,,
GA,Clay,697,566,8,NA,NA,1271,,
GA,Clayton,78220,12645,1647,NA,NA,92512,,
GA,Clinch,686,1727,34,NA,NA,2447,,
GA,Cobb,160121,152912,14466,NA,NA,327499,,
GA,Coffee,4094,9588,233,NA,NA,13915,,
GA,Colquitt,3463,9898,240,NA,NA,13601,,
GA,Columbia,18887,43085,2270,NA,NA,64242,,
GA,Cook,1753,4176,112,NA,NA,6041,,
GA,Coweta,16583,42533,2235,NA,NA,61351,,
GA,Crawford,1421,3635,106,NA,NA,5162,,
GA,Crisp,2837,4549,126,NA,NA,7512,,
GA,Dade,965,5051,226,NA,NA,6242,,
GA,Dawson,1448,9900,356,NA,NA,11704,,
GA,Decatur,4124,6020,126,NA,NA,10270,,
GA,DeKalb,251370,51468,9666,NA,NA,312504,,
GA,Dodge,1839,5021,138,NA,NA,6998,,
GA,Dooly,1872,1951,36,NA,NA,3859,,
GA,Dougherty,23311,10232,475,NA,NA,34018,,
GA,Douglas,31005,24817,1594,NA,NA,57416,,
GA,Early,2168,2552,65,NA,NA,4785,,
GA,Echols,156,1007,13,NA,NA,1176,,
GA,Effingham,4853,17874,679,NA,NA,23406,,
GA,Elbert,2539,5292,139,NA,NA,7970,,
GA,Emanuel,2435,5335,75,NA,NA,7845,,
GA,Evans,1130,2404,68,NA,NA,3602,,
GA,Fannin,1923,9632,222,NA,NA,11777,,
GA,Fayette,23284,35048,2103,NA,NA,60435,,
GA,Floyd,9159,24114,1084,NA,NA,34357,,
GA,Forsyth,23462,69851,4091,NA,NA,97404,,
GA,Franklin,1243,7054,177,NA,NA,8474,,
GA,Fulton,297051,117783,15765,NA,NA,430599,,
GA,Gilmer,1965,10477,293,NA,NA,12735,,
GA,Glascock,138,1235,17,NA,NA,1390,,
GA,Glynn,11775,21512,825,NA,NA,34112,,
GA,Gordon,3181,15191,507,NA,NA,18879,,
GA,Grady,3013,6053,135,NA,NA,9201,,
GA,Greene,3199,5490,151,NA,NA,8840,,
GA,Gwinnett,166153,146989,12494,NA,NA,325636,,
GA,Habersham,2483,13190,461,NA,NA,16134,,
GA,Hall,16180,51733,2307,NA,NA,70220,,
GA,Hancock,2701,843,36,NA,NA,3580,,
GA,Haralson,1475,9585,264,NA,NA,11324,,
GA,Harris,4086,11936,379,NA,NA,16401,,
GA,Hart,2585,7286,209,NA,NA,10080,,
GA,Heard,743,3370,93,NA,NA,4206,,
GA,Henry,50057,45724,2505,NA,NA,98286,,
GA,Houston,22553,35430,1761,NA,NA,59744,,
GA,Irwin,891,2716,58,NA,NA,3665,,
GA,Jackson,4491,21784,834,NA,NA,27109,,
GA,Jasper,1544,4360,119,NA,NA,6023,,
GA,Jeff Davis,901,4104,86,NA,NA,5091,,
GA,Jefferson,3821,3063,70,NA,NA,6954,,
GA,Jenkins,1123,1895,34,NA,NA,3052,,
GA,Johnson,1136,2519,27,NA,NA,3682,,
GA,Jones,3961,8305,260,NA,NA,12526,,
GA,Lamar,2270,5190,126,NA,NA,7586,,
GA,Lanier,806,1984,73,NA,NA,2863,,
GA,Laurens,6752,12411,313,NA,NA,19476,,
GA,Lee,3170,10646,299,NA,NA,14115,,
GA,Liberty,9556,6134,427,NA,NA,16117,,
GA,Lincoln,1273,2759,70,NA,NA,4102,,
GA,Long,1360,2626,131,NA,NA,4117,,
GA,Lowndes,15064,21635,929,NA,NA,37628,,
GA,Lumpkin,2220,9619,495,NA,NA,12334,,
GA,Macon,2705,1540,42,NA,NA,4287,,
GA,Madison,2425,9201,328,NA,NA,11954,,
GA,Marion,1213,1921,49,NA,NA,3183,,
GA,McDuffie,3699,5432,137,NA,NA,9268,,
GA,McIntosh,2303,3487,113,NA,NA,5903,,
GA,Meriwether,3804,5222,165,NA,NA,9191,,
GA,Miller,623,1891,30,NA,NA,2544,,
GA,Mitchell,3493,4279,93,NA,NA,7865,,
GA,Monroe,3571,8832,284,NA,NA,12687,,
GA,Montgomery,847,2670,45,NA,NA,3562,,
GA,Morgan,2663,6559,218,NA,NA,9440,,
GA,Murray,1800,10341,283,NA,NA,12424,,
GA,Muscogee,39851,26976,1831,NA,NA,68658,,
GA,Newton,21943,20913,947,NA,NA,43803,,
GA,Oconee,5581,13425,925,NA,NA,19931,,
GA,Oglethorpe,1831,4625,199,NA,NA,6655,,
GA,Paulding,18025,44662,1954,NA,NA,64641,,
GA,Peach,5100,5413,211,NA,NA,10724,,
GA,Pickens,1979,11651,354,NA,NA,13984,,
GA,Pierce,903,6302,93,NA,NA,7298,,
GA,Pike,1240,7278,163,NA,NA,8681,,
GA,Polk,2867,11014,289,NA,NA,14170,,
GA,Pulaski,1104,2437,58,NA,NA,3599,,
GA,Putnam,2758,6544,170,NA,NA,9472,,
GA,Quitman,461,575,8,NA,NA,1044,,
GA,Rabun,1444,6287,219,NA,NA,7950,,
GA,Randolph,1598,1271,28,NA,NA,2897,,
GA,Richmond,48814,24461,1811,NA,NA,75086,,
GA,Rockdale,23255,13478,923,NA,NA,37656,,
GA,Schley,401,1472,36,NA,NA,1909,,
GA,Screven,2300,3305,94,NA,NA,5699,,
GA,Seminole,1189,2345,48,NA,NA,3582,,
GA,Spalding,9357,15646,597,NA,NA,25600,,
GA,Stephens,1837,7686,243,NA,NA,9766,,
GA,Stewart,1222,805,28,NA,NA,2055,,
GA,Sumter,5520,5276,178,NA,NA,10974,,
GA,Talbot,2002,1196,46,NA,NA,3244,,
GA,Taliaferro,545,349,3,NA,NA,897,,
GA,Tattnall,1681,5096,109,NA,NA,6886,,
GA,Taylor,1296,2064,45,NA,NA,3405,,
GA,Telfair,1313,2450,32,NA,NA,3795,,
GA,Terrell,2267,1874,40,NA,NA,4181,,
GA,Thomas,7142,11228,368,NA,NA,18738,,
GA,Tift,4347,9584,244,NA,NA,14175,,
GA,Toombs,2338,6615,158,NA,NA,9111,,
GA,Towns,1210,5383,146,NA,NA,6739,,
GA,Treutlen,862,1809,32,NA,NA,2703,,
GA,Troup,9713,15750,561,NA,NA,26024,,
GA,Turner,1246,2095,53,NA,NA,3394,,
GA,Twiggs,1971,2035,50,NA,NA,4056,,
GA,Union,1963,9852,229,NA,NA,12044,,
GA,Upson,3475,7292,167,NA,NA,10934,,
GA,Walker,4215,18950,791,NA,NA,23956,,
GA,Walton,8292,31125,1055,NA,NA,40472,,
GA,Ware,3440,8513,206,NA,NA,12159,,
GA,Warren,1314,991,28,NA,NA,2333,,
GA,Washington,4200,4149,98,NA,NA,8447,,
GA,Wayne,2041,8153,192,NA,NA,10386,,
GA,Webster,473,630,13,NA,NA,1116,,
GA,Wheeler,646,1421,35,NA,NA,2102,,
GA,White,1674,9761,348,NA,NA,11783,,
GA,Whitfield,7937,21537,924,NA,NA,30398,,
GA,Wilcox,852,2096,25,NA,NA,2973,,
GA,Wilkes,1848,2572,57,NA,NA,4477,,
GA,Wilkinson,1894,2333,51,NA,NA,4278,,
GA,Worth,2020,6152,108,NA,NA,8280,,
HI,City and County of Honolulu,175696,90326,10467,6476,2825,285790,,
HI,County of Hawaii,41259,17501,2470,2852,785,64867,,
HI,County of Kauai,16456,7574,982,1019,304,26335,,
HI,County of Maui,33480,13446,2035,2390,594,51945,,
IA,Adair,1133,2461,127,14,113,3848,,
IA,Adams,565,1395,93,9,69,2131,,
IA,Allamakee,2421,4093,227,46,248,7035,,
IA,Appanoose,1814,4033,139,42,168,6196,,
IA,Audubon,1080,2136,107,24,139,3486,,
IA,Benton,4678,8232,542,86,433,13971,,
IA,Black Hawk,32233,27476,2368,610,2320,65007,,
IA,Boone,5541,7484,643,104,538,14310,,
IA,Bremer,5356,7208,543,81,503,13691,,
IA,Buchanan,3970,5510,478,54,365,10377,,
IA,Buena Vista,2856,4903,288,48,286,8381,,
IA,Butler,2157,4921,219,43,243,7583,,
IA,Calhoun,1398,3468,173,18,161,5218,,
IA,Carroll,3309,6638,318,61,356,10682,,
IA,Cass,1951,4761,206,52,228,7198,,
IA,Cedar,3599,5295,365,70,302,9631,,
IA,Cerro Gordo,9862,11621,851,130,673,23137,,
IA,Cherokee,1679,4192,206,29,209,6315,,
IA,Chickasaw,2266,3742,236,48,226,6518,,
IA,Clarke,1465,2713,160,18,153,4509,,
IA,Clay,2249,5877,288,35,257,8706,,
IA,Clayton,3237,5317,334,51,278,9217,,
IA,Clinton,10095,11276,825,184,967,23347,,
IA,Crawford,1991,4617,172,33,224,7037,,
IA,Dallas,15701,19339,1757,181,1610,38588,,
IA,Davis,977,2723,85,25,133,3943,,
IA,Decatur,1201,2296,123,29,135,3784,,
IA,Delaware,2957,5694,337,40,311,9339,,
IA,Des Moines,8212,9529,635,134,761,19271,,
IA,Dickinson,3056,6753,292,54,302,10457,,
IA,Dubuque,22850,23460,2013,379,1519,50221,,
IA,Emmet,1357,3124,139,26,164,4810,,
IA,Fayette,3689,5620,328,62,399,10098,,
IA,Floyd,3179,4375,241,60,304,8159,,
IA,Franklin,1493,3163,188,31,171,5046,,
IA,Fremont,963,2407,115,21,127,3633,,
IA,Greene,1691,2820,160,31,174,4876,,
IA,Grundy,1856,4527,233,38,290,6944,,
IA,Guthrie,1732,3628,258,19,179,5816,,
IA,Hamilton,2726,4463,259,31,306,7785,,
IA,Hancock,1587,3977,166,24,179,5933,,
IA,Hardin,2787,5254,298,28,272,8639,,
IA,Harrison,2131,4902,210,50,259,7552,,
IA,Henry,2904,5779,337,113,367,9500,,
IA,Howard,1677,2611,131,38,183,4640,,
IA,Humboldt,1252,3568,127,20,174,5141,,
IA,Ida,792,2655,103,9,89,3648,,
IA,Iowa,3084,5205,317,61,335,9002,,
IA,Jackson,3837,5824,319,85,439,10504,,
IA,Jasper,7109,10560,715,95,747,19226,,
IA,Jefferson,3710,3748,246,256,325,8285,,
IA,Johnson,50200,21044,2758,878,2596,77476,,
IA,Jones,3787,5720,305,62,362,10236,,
IA,Keokuk,1342,3390,139,28,136,5035,,
IA,Kossuth,2543,5653,194,33,319,8742,,
IA,Lee,6215,8803,510,145,674,16347,,
IA,Linn,58935,48390,5557,1005,4229,118116,,
IA,Louisa,1648,3069,136,28,195,5076,,
IA,Lucas,1239,2877,115,28,133,4392,,
IA,Lyon,920,5192,137,18,164,6431,,
IA,Madison,2678,5360,347,41,280,8706,,
IA,Mahaska,2619,7432,318,38,316,10723,,
IA,Marion,5482,10962,706,73,768,17991,,
IA,Marshall,7652,9146,577,117,683,18175,,
IA,Mills,2090,5067,307,56,252,7772,,
IA,Mitchell,1888,3190,210,28,205,5521,,
IA,Monona,1247,3120,112,22,128,4629,,
IA,Monroe,1056,2638,104,13,96,3907,,
IA,Montgomery,1314,3436,152,38,162,5102,,
IA,Muscatine,8368,9584,748,183,740,19623,,
IA,O'Brien,1315,5752,197,28,168,7460,,
IA,Osceola,552,2531,73,10,85,3251,,
IA,Page,1807,4893,176,37,208,7121,,
IA,Palo Alto,1398,3081,131,20,130,4760,,
IA,Plymouth,2885,9680,343,52,314,13274,,
IA,Pocahontas,963,2702,115,14,124,3918,,
IA,Polk,119804,93492,10029,1737,8323,233385,,
IA,Pottawattamif,15355,24447,1469,327,1460,43058,,
IA,Poweshiek,4304,4946,283,73,310,9916,,
IA,Ringgold,753,1824,72,8,95,2752,,
IA,Sac,1270,3703,129,23,132,5257,,
IA,Scott,40440,39149,3555,784,3358,87286,,
IA,Shelby,1662,4362,174,28,222,6448,,
IA,Sioux,2300,14785,435,53,759,18332,,
IA,Story,25709,19458,3014,491,2302,50974,,
IA,Tama,3196,4971,245,79,375,8866,,
IA,Taylor,758,2111,97,10,89,3065,,
IA,Union,1922,3525,213,52,173,5885,,
IA,Van Buren,845,2527,83,19,121,3595,,
IA,Wapello,5594,8715,380,122,466,15277,,
IA,Warren,10411,14814,1275,123,884,27507,,
IA,Washington,3943,6173,459,79,438,11092,,
IA,Wayne,719,2069,78,17,106,2989,,
IA,Webster,6305,10056,569,113,550,17593,,
IA,Winnebago,1931,3447,218,34,234,5864,,
IA,Winneshiek,5254,5344,382,99,432,11511,,
IA,Woodbury,16210,24727,1179,324,1727,44167,,
IA,Worth,1530,2453,165,24,133,4305,,
IA,Wright,1896,3800,176,35,185,6092,,
ID,Ada,75677,93752,9984,3138,13118,195669,,
ID,Adams,415,1556,83,19,110,2183,,
ID,Bannock,10342,17180,1471,518,3905,33416,,
ID,Bear Lake,255,2203,54,11,405,2928,,
ID,Benewah,770,3103,151,42,119,4185,,
ID,Bingham,2924,10907,417,124,2253,16625,,
ID,Blaine,6416,3340,424,176,368,10724,,
ID,Boise,777,2673,173,35,156,3814,,
ID,Bonner,5819,13343,762,396,623,20943,,
ID,Bonneville,8930,26699,1634,399,6559,44221,,
ID,Boundary,933,3789,161,80,200,5163,,
ID,Butte,160,914,25,7,124,1230,,
ID,Camas,110,410,23,6,41,590,,
ID,Canyon,16883,47222,2778,797,5105,72785,,
ID,Caribou,271,2275,64,15,410,3035,,
ID,Cassia,1036,5949,202,37,954,8178,,
ID,Clark,44,203,4,1,31,283,,
ID,Clearwater,704,2852,97,38,110,3801,,
ID,Custer,427,1777,67,30,113,2414,,
ID,Elmore,1814,5816,332,77,483,8522,,
ID,Franklin,385,3901,117,30,1066,5499,,
ID,Fremont,651,4090,127,20,827,5715,,
ID,Gem,1229,5980,241,57,447,7954,,
ID,Gooding,930,3743,110,30,378,5191,,
ID,Idaho,1196,6441,254,52,290,8233,,
ID,Jefferson,976,8436,274,55,1734,11475,,
ID,Jerome,1329,4644,218,52,508,6751,,
ID,Kootenai,16264,44449,2604,744,2249,66310,,
ID,Latah,8093,7265,1197,463,1155,18173,,
ID,Lemhi,733,3011,138,31,183,4096,,
ID,Lewis,270,1202,62,13,43,1590,,
ID,Lincoln,360,1184,54,18,132,1748,,
ID,Madison,1201,8941,612,69,4865,15688,,
ID,Minidoka,1167,4887,207,41,569,6871,,
ID,Nez Perce,4828,10699,879,203,592,17201,,
ID,Oneida,184,1531,37,3,313,2068,,
ID,Owyhee,591,3052,108,26,148,3925,,
ID,Payette,1507,6489,247,59,402,8704,,
ID,Power,699,1666,92,26,275,2758,,
ID,Shoshone,1384,3297,219,54,166,5120,,
ID,Teton,2159,2167,184,99,367,4976,,
ID,Twin Falls,6233,19828,1076,326,2411,29874,,
ID,Valley,1913,2906,230,53,247,5349,,
ID,Washington,776,3283,138,26,232,4455,,
IL,ADAMS,7680,22790,1168,249,60,31947,,
IL,ALEXANDER,1262,1496,48,14,0,2820,,
IL,BOND,2071,4889,447,67,36,7510,,
IL,BOONE,8998,12282,1068,330,51,22729,,
IL,BROWN,476,1796,77,10,0,2359,,
IL,BUREAU,6033,9287,842,197,30,16389,,
IL,CALHOUN,739,1721,72,26,3,2561,,
IL,CARROLL,2452,4434,395,98,14,7393,,
IL,CASS,1624,3216,172,51,12,5075,,
IL,CHAMPAIGN,50162,33371,4566,1847,623,90569,,
IL,CHRISTIAN,3993,10543,662,149,17,15364,,
IL,CLARK,1882,5622,277,49,11,7841,,
IL,CLAY,1024,5021,209,48,12,6314,,
IL,CLINTON,3948,12412,813,125,29,17327,,
IL,COLES,7312,13003,1025,287,52,21679,,
IL,COOK,1611946,453287,58678,32484,2220,2158615,,
IL,CRAWFORD,1992,6277,324,68,11,8672,,
IL,CUMBERLAND,1031,4206,238,47,4,5526,,
IL,DEKALB,20466,19091,2482,751,213,43003,,
IL,DEWITT,1910,5077,431,61,13,7492,,
IL,DOUGLAS,1949,5698,362,90,26,8125,,
IL,DUPAGE,228622,166415,20357,6367,1905,423666,,
IL,EDGAR,1793,5645,328,49,26,7841,,
IL,EDWARDS,434,2778,91,12,9,3324,,
IL,EFFINGHAM,3083,13635,644,100,52,17514,,
IL,FAYETTE,1819,7372,283,57,21,9552,,
IL,FORD,1414,4480,323,87,34,6338,,
IL,FRANKLIN,4727,13116,541,183,0,18567,,
IL,FULTON,6133,8492,780,239,7,15651,,
IL,GALLATIN,657,1942,73,20,7,2699,,
IL,GREENE,1205,4145,164,39,6,5559,,
IL,GRUNDY,8065,13454,1140,323,40,23022,,
IL,HAMILTON,802,3206,114,24,10,4156,,
IL,HANCOCK,2139,6430,348,64,68,9049,,
IL,HARDIN,420,1653,46,18,0,2137,,
IL,HENDERSON,1155,2155,158,19,2,3489,,
IL,HENRY,8871,13985,1243,200,66,24365,,
IL,IROQUOIS,2504,9750,554,150,38,12996,,
IL,JACKSON,11634,10843,1081,649,61,24268,,
IL,JASPER,924,3975,181,26,6,5112,,
IL,JEFFERSON,4425,11695,573,158,25,16876,,
IL,JERSEY,2679,7748,410,94,7,10938,,
IL,JODAVIESS,4462,6121,500,116,26,11225,,
IL,JOHNSON,1142,4649,182,57,13,6043,,
IL,KANE,103665,82734,9292,2896,727,199314,,
IL,KANKAKEE,18971,25129,1992,587,104,46783,,
IL,KENDALL,24884,24961,2675,742,185,53447,,
IL,KNOX,10083,10737,1109,278,36,22243,,
IL,LAKE,171095,109767,13312,3821,1045,299040,,
IL,LASALLE,19543,26689,2298,649,72,49251,,
IL,LAWRENCE,1290,4521,194,41,12,6058,,
IL,LEE,5528,8612,896,226,42,15304,,
IL,LIVINGSTON,4023,10208,777,125,73,15206,,
IL,LOGAN,3313,8181,537,130,96,12257,,
IL,MACON,18343,26866,1851,459,89,47608,,
IL,MACOUPIN,6689,14322,934,247,31,22223,,
IL,MADISON,50587,70490,5472,1838,372,128759,,
IL,MARION,4369,11859,548,164,24,16964,,
IL,MARSHALL,1789,3785,266,78,21,5939,,
IL,MASON,2014,4058,321,54,7,6454,,
IL,MASSAC,1558,4846,194,42,14,6654,,
IL,MCDONOUGH,5288,6795,635,210,52,12980,,
IL,MCHENRY,60803,71612,7180,2155,540,142290,,
IL,MCLEAN,36196,37237,4855,1208,339,79835,,
IL,MENARD,1817,4231,311,74,31,6464,,
IL,MERCER,3071,4807,475,82,12,8447,,
IL,MONROE,5535,12629,742,200,0,19106,,
IL,MONTGOMERY,3504,8630,599,128,17,12878,,
IL,MORGAN,4696,9076,670,189,14,14645,,
IL,MOULTRIE,1481,4455,238,44,13,6231,,
IL,OGLE,8050,14352,1159,275,33,23869,,
IL,PEORIA,38060,35633,3725,1085,599,79102,,
IL,PERRY,2462,6855,347,113,21,9798,,
IL,PIATT,2645,5634,558,83,52,8972,,
IL,PIKE,1413,5754,257,40,16,7480,,
IL,POPE,375,1678,62,18,3,2136,,
IL,PULASKI,962,1675,55,20,0,2712,,
IL,PUTNAM,1147,1767,136,35,1,3086,,
IL,RANDOLPH,3439,10023,490,135,12,14099,,
IL,RICHLAND,1584,5739,235,81,10,7649,,
IL,ROCK ISLAND,32298,26998,3015,733,127,63171,,
IL,SALINE,2572,8276,358,77,13,11296,,
IL,SANGAMON,40907,49944,4512,1443,428,97234,,
IL,SCHUYLER,1075,2524,154,41,6,3800,,
IL,SCOTT,535,1966,68,22,6,2597,,
IL,SHELBY,2288,8229,372,55,39,10983,,
IL,ST. CLAIR,60756,53857,4181,1473,313,120580,,
IL,STARK,751,1778,149,33,6,2717,,
IL,STEPHENSON,7768,11083,936,250,49,20086,,
IL,TAZEWELL,20685,38707,3358,830,351,63931,,
IL,UNION,2402,5790,219,126,14,8551,,
IL,VERMILION,10039,19087,1097,296,51,30570,,
IL,WABASH,1151,4047,175,42,13,5428,,
IL,WARREN,2987,4275,359,92,17,7730,,
IL,WASHINGTON,1448,5571,289,75,11,7394,,
IL,WAYNE,1048,6967,191,55,4,8265,,
IL,WHITE,1412,5640,205,34,5,7296,,
IL,WHITESIDE,11035,12615,1285,326,19,25280,,
IL,WILL,151927,132720,11822,3885,550,300904,,
IL,WILLIAMSON,8581,21570,997,396,79,31623,,
IL,WINNEBAGO,55713,55624,5064,1703,272,118376,,
IL,WOODFORD,5092,13207,942,214,177,19632,,
IN,Adams,2805,9648,595,23,19,13090,,
IN,Allen,55382,83930,6802,702,321,147137,,
IN,Bartholomew,9841,20640,1911,60,38,32490,,
IN,Benton,860,2579,215,9,3,3666,,
IN,Blackford,1243,3350,230,15,1,4839,,
IN,Boone,10181,19654,2226,75,42,32178,,
IN,Brown,2518,5016,375,31,5,7945,,
IN,Carroll,1892,6273,445,24,9,8643,,
IN,Cass,3759,9701,680,49,20,14209,,
IN,Clark,18808,30035,2304,0,0,51147,,
IN,Clay,2306,8531,426,11,8,11282,,
IN,Clinton,2819,8531,547,31,8,11936,,
IN,Crawford,1323,3015,255,0,0,4593,,
IN,Daviess,1800,8545,391,25,7,10768,,
IN,Dearborn,4883,18113,917,46,28,23987,,
IN,Decatur,2121,8490,487,17,12,11127,,
IN,DeKalb,3942,12054,821,61,24,16902,,
IN,Delaware,18153,24263,2388,252,67,45123,,
IN,Dubois,5389,13365,1163,45,22,19984,,
IN,Elkhart,20740,41867,2716,204,103,65630,,
IN,Fayette,2252,6839,439,0,0,9530,,
IN,Floyd,13945,21432,1861,157,30,37425,,
IN,Fountain,1476,5662,337,10,7,7492,,
IN,Franklin,1969,8669,358,15,2,11013,,
IN,Fulton,1960,6010,404,0,0,8374,,
IN,Gibson,3721,11081,673,9,0,15484,,
IN,Grant,7010,17008,1198,59,37,25312,,
IN,Greene,2929,10277,559,35,1,13801,,
IN,Hamilton,57263,87404,9122,299,168,154256,,
IN,Hancock,8904,25074,2077,89,37,36181,,
IN,Harrison,4783,12943,759,48,25,18558,,
IN,Hendricks,22600,48337,4338,205,79,75559,,
IN,Henry,5124,13895,1056,57,23,20155,,
IN,Howard,11215,23675,1864,60,29,36843,,
IN,Huntington,3506,11649,819,31,38,16043,,
IN,Jackson,3843,12859,832,30,9,17573,,
IN,Jasper,3329,9382,620,33,14,13378,,
IN,Jay,1889,5697,376,21,3,7986,,
IN,Jefferson,4326,8546,598,33,41,13544,,
IN,Jennings,2364,8224,529,16,17,11150,,
IN,Johnson,17318,45456,3455,211,60,66500,,
IN,Knox,3772,11077,634,26,7,15516,,
IN,Kosciusko,6313,23935,1687,60,89,32084,,
IN,La Porte,19798,22687,2521,163,34,45203,,
IN,LaGrange,2080,7025,447,7,7,9566,,
IN,Lake,116935,75625,7789,772,84,201205,,
IN,Lawrence,4210,14035,832,66,9,19152,,
IN,Madison,18595,32376,2689,207,42,53909,,
IN,Marion,212899,130360,18190,726,197,362372,,
IN,Marshall,4798,12288,924,44,28,18082,,
IN,Martin,881,3697,231,0,0,4809,,
IN,Miami,2766,9975,699,30,12,13482,,
IN,Monroe,34216,20592,2917,627,102,58454,,
IN,Montgomery,3362,11059,688,38,9,15156,,
IN,Morgan,6040,23674,1472,64,30,31280,,
IN,Newton,1404,4077,314,0,0,5795,,
IN,Noble,3904,12198,788,0,0,16890,,
IN,Ohio,686,2118,113,4,0,2921,,
IN,Orange,2048,5803,341,0,0,8192,,
IN,Owen,1946,6153,423,29,6,8557,,
IN,Parke,1441,4863,272,5,1,6582,,
IN,Perry,3062,4556,407,24,6,8055,,
IN,Pike,1297,4398,282,0,0,5977,,
IN,Porter,33676,38832,4253,367,62,77190,,
IN,Posey,3521,8404,542,0,0,12467,,
IN,Pulaski,1327,3854,256,13,9,5459,,
IN,Putnam,3356,10637,687,20,15,14715,,
IN,Randolph,2446,7517,495,0,0,10458,,
IN,Ripley,2471,9806,513,9,11,12810,,
IN,Rush,1525,5292,397,0,0,7214,,
IN,Scott,2642,6074,344,26,15,9101,,
IN,Shelby,4247,12718,970,43,16,17994,,
IN,Spencer,2861,6572,526,15,5,9979,,
IN,St. Joseph,52252,52021,5186,405,196,110060,,
IN,Starke,2489,6367,370,0,0,9226,,
IN,Steuben,3744,10133,662,18,9,14566,,
IN,Sullivan,2113,6138,308,0,0,8559,,
IN,Switzerland,930,2558,151,5,55,3699,,
IN,Tippecanoe,27282,30768,4002,339,124,62515,,
IN,Tipton,1587,5589,334,0,0,7510,,
IN,Union,715,2445,126,5,0,3291,,
IN,Vanderburgh,28530,40496,3263,191,27,72507,,
IN,Vermillion,2081,4513,321,17,7,6939,,
IN,Vigo,15931,21937,1723,190,37,39818,,
IN,Wabash,3018,9821,578,39,12,13468,,
IN,Warren,839,2898,184,5,4,3930,,
IN,Warrick,9086,19113,1390,0,0,29589,,
IN,Washington,2636,8209,491,32,14,11382,,
IN,Wayne,8322,16028,1225,2,2,25579,,
IN,Wells,2586,10005,539,28,27,13185,,
IN,White,2590,6893,530,24,16,10053,,
IN,Whitley,3379,11358,799,58,29,15623,,
KS,statewide,427005,671018,55406,23506,7467,1184402,,
KY,Adair,1323,6637,141,35,97,8233,,
KY,Allen,1349,6466,161,46,74,8096,,
KY,Anderson,2634,8242,319,54,173,11422,,
KY,Ballard,816,3161,77,20,27,4101,,
KY,Barren,4275,13483,455,93,182,18488,,
KY,Bath,1361,3082,75,24,45,4587,,
KY,Bell,1720,7764,144,42,48,9718,,
KY,Boone,15026,39082,2299,380,831,57618,,
KY,Bourbon,2791,5569,283,52,108,8803,,
KY,Boyd,6021,13591,496,167,179,20454,,
KY,Boyle,4281,8040,365,73,187,12946,,
KY,Bracken,705,2711,51,20,40,3527,,
KY,Breathitt,1537,3991,117,35,58,5738,,
KY,Breckinridge,1960,6484,194,47,89,8774,,
KY,Bullitt,8255,26210,964,253,387,36069,,
KY,Butler,947,4428,136,11,54,5576,,
KY,Caldwell,1260,4507,118,32,58,5975,,
KY,Calloway,4749,10367,492,150,291,16049,,
KY,Campbell,14658,25050,1789,422,591,42510,,
KY,Carlisle,432,2094,42,12,21,2601,,
KY,Carroll,1106,2588,100,24,37,3855,,
KY,Carter,2276,7587,237,58,120,10278,,
KY,Casey,767,5482,121,28,41,6439,,
KY,Christian,7188,14108,474,120,193,22083,,
KY,Clark,4706,10710,453,121,215,16205,,
KY,Clay,752,5861,83,26,45,6767,,
KY,Clinton,547,3809,60,15,31,4462,,
KY,Crittenden,617,3290,76,17,37,4037,,
KY,Cumberland,459,2502,67,11,27,3066,,
KY,Daviess,14163,28907,1488,453,796,45807,,
KY,Edmonson,979,4135,77,20,33,5244,,
KY,Elliott,740,2000,67,19,29,2855,,
KY,Estill,1108,4236,129,30,42,5545,,
KY,Fayette,69778,56894,5230,1580,2833,136315,,
KY,Fleming,1348,4722,109,20,61,6260,,
KY,Floyd,4015,11993,357,56,119,16540,,
KY,Franklin,10717,11819,725,236,368,23865,,
KY,Fulton,774,1549,35,7,17,2382,,
KY,Gallatin,749,2443,100,18,28,3338,,
KY,Garrard,1453,5904,157,33,76,7623,,
KY,Grant,1910,7268,226,71,84,9559,,
KY,Graves,3308,12671,411,80,136,16606,,
KY,Grayson,1959,8219,259,46,93,10576,,
KY,Green,832,4372,84,24,21,5333,,
KY,Greenup,4146,11546,319,109,157,16277,,
KY,Hancock,1244,2788,129,44,90,4295,,
KY,Hardin,13944,26971,1413,346,482,43156,,
KY,Harlan,1372,9129,156,39,61,10757,,
KY,Harrison,2031,5435,184,46,85,7781,,
KY,Hart,1730,5320,140,39,35,7264,,
KY,Henderson,6707,12159,507,142,195,19710,,
KY,Henry,1828,4944,224,58,95,7149,,
KY,Hickman,449,1657,26,6,19,2157,,
KY,Hopkins,4310,15277,478,97,183,20345,,
KY,Jackson,482,4889,79,20,31,5501,,
KY,Jefferson,190836,143768,10188,3224,5083,353099,,
KY,Jessamine,6144,15474,829,170,709,23326,,
KY,Johnson,1250,8043,163,60,56,9572,,
KY,Kenton,24214,42958,3093,703,1030,71998,,
KY,Knott,1245,4357,102,13,46,5763,,
KY,Knox,1761,9885,189,64,113,12012,,
KY,Larue,1278,4799,174,28,88,6367,,
KY,Laurel,3440,20592,473,114,214,24833,,
KY,Lawrence,1045,4816,107,32,42,6042,,
KY,Lee,444,2151,42,7,23,2667,,
KY,Leslie,400,4015,39,15,23,4492,,
KY,Letcher,1542,7293,210,37,52,9134,,
KY,Lewis,785,4363,95,16,39,5298,,
KY,Lincoln,1865,7338,226,44,88,9561,,
KY,Livingston,887,3570,115,24,49,4645,,
KY,Logan,2755,7778,229,43,94,10899,,
KY,Lyon,1045,2789,74,15,39,3962,,
KY,Madison,11793,23431,1189,353,605,37371,,
KY,Magoffin,1172,3824,66,17,37,5116,,
KY,Marion,2679,5122,215,33,62,8111,,
KY,Marshall,3672,12322,426,84,194,16698,,
KY,Martin,363,3503,52,13,22,3953,,
KY,Mason,1970,4944,173,38,94,7219,,
KY,McCracken,9134,20774,839,217,343,31307,,
KY,McCreary,664,5012,59,18,23,5776,,
KY,McLean,988,3381,137,15,45,4566,,
KY,Meade,3026,8660,333,97,115,12231,,
KY,Menifee,700,2010,43,14,12,2779,,
KY,Mercer,2395,7740,275,68,107,10585,,
KY,Metcalfe,976,3491,86,22,45,4620,,
KY,Monroe,601,4278,76,13,23,4991,,
KY,Montgomery,3158,7856,264,68,106,11452,,
KY,Morgan,1006,3628,63,26,52,4775,,
KY,Muhlenberg,3272,9393,230,44,121,13060,,
KY,Nelson,6434,13431,565,131,241,20802,,
KY,Nicholas,787,1957,65,9,23,2841,,
KY,Ohio,2080,7942,207,64,105,10398,,
KY,Oldham,10268,20469,1229,282,605,32853,,
KY,Owen,1062,3745,122,25,47,5001,,
KY,Owsley,256,1474,24,0,5,1759,,
KY,Pendleton,1164,4604,145,27,67,6007,,
KY,Perry,2136,8158,168,47,63,10572,,
KY,Pike,4280,19747,413,86,139,24665,,
KY,Powell,1272,3513,118,27,27,4957,,
KY,Pulaski,4208,22902,562,127,242,28041,,
KY,Robertson,222,759,19,5,8,1013,,
KY,Rockcastle,915,5609,87,25,55,6691,,
KY,Rowan,3295,5174,207,85,87,8848,,
KY,Russell,1093,6863,153,14,51,8174,,
KY,Scott,7715,15052,853,139,441,24200,,
KY,Shelby,6276,13196,629,138,341,20580,,
KY,Simpson,2144,5077,200,38,72,7531,,
KY,Spencer,1921,7196,237,44,117,9515,,
KY,Taylor,2553,8320,233,53,147,11306,,
KY,Todd,1042,3612,64,26,35,4779,,
KY,Trigg,1587,4931,121,45,67,6751,,
KY,Trimble,879,2771,88,20,40,3798,,
KY,Union,1331,4701,115,29,35,6211,,
KY,Warren,16966,28673,1605,415,795,48454,,
KY,Washington,1420,4013,111,17,75,5636,,
KY,Wayne,1431,6371,116,30,44,7992,,
KY,Webster,1240,4397,111,22,35,5805,,
KY,Whitley,2067,11312,242,41,112,13774,,
KY,Wolfe,753,1804,42,9,27,2635,,
KY,Woodford,4958,7697,529,117,262,13563,,
LA,Acadia,5638,21162,281,106,202,27389,,
LA,Allen,2106,6867,102,50,120,9245,,
LA,Ascension,16476,36143,1184,324,551,54678,,
LA,Assumption,3931,6714,127,39,93,10904,,
LA,Avoyelles,5035,11165,188,69,129,16586,,
LA,Beauregard,2393,12238,225,64,158,15078,,
LA,Bienville,3129,3756,54,23,43,7005,,
LA,Bossier,12641,35474,1024,263,446,49848,,
LA,Caddo,53483,49006,1861,665,789,105804,,
LA,Calcasieu,26296,54191,1786,551,961,83785,,
LA,Caldwell,788,3822,28,14,40,4692,,
LA,Cameron,323,3256,57,16,40,3692,,
LA,Catahoula,1322,3479,17,14,24,4856,,
LA,Claiborne,2717,3585,45,25,49,6421,,
LA,Concordia,3272,5477,68,14,41,8872,,
LA,De Soto,5165,8068,128,33,106,13500,,
LA,East Baton Rouge,102828,84660,4959,1643,2401,196491,,
LA,East Carroll,1838,1059,16,6,20,2939,,
LA,East Feliciana,4235,5569,102,38,98,10042,,
LA,Evangeline,4208,10360,116,66,132,14882,,
LA,Franklin,2506,6514,68,28,46,9162,,
LA,Grant,1181,7408,126,34,72,8821,,
LA,Iberia,10698,20903,443,170,240,32454,,
LA,Iberville,8324,7320,165,92,142,16043,,
LA,Jackson,2139,5169,74,20,62,7464,,
LA,Jefferson,73670,100398,4306,1611,1654,181639,,
LA,Jefferson Davis,3080,10775,185,71,166,14277,,
LA,Lafayette,32726,68195,2833,851,998,105603,,
LA,Lafourche,8423,31959,734,233,296,41645,,
LA,Lasalle,605,5836,53,19,56,6569,,
LA,Lincoln,7107,10761,440,120,241,18669,,
LA,Livingston,6950,48824,1151,292,513,57730,,
LA,Madison,2744,1927,17,15,29,4732,,
LA,Morehouse,5155,6502,73,46,76,11852,,
LA,Natchitoches,7144,8968,260,91,158,16621,,
LA,Orleans,133996,24292,3638,2546,1340,165812,,
LA,Ouachita,24428,41734,980,343,532,68017,,
LA,Plaquemines,3347,6900,179,74,73,10573,,
LA,Pointe Coupee,4764,6789,86,35,87,11761,,
LA,Rapides,18322,36816,858,314,534,56844,,
LA,Red River,1938,2391,47,11,35,4422,,
LA,Richland,3157,6287,67,35,51,9597,,
LA,Sabine,1703,7879,97,24,84,9787,,
LA,St. Bernard,4960,10237,308,169,141,15815,,
LA,St. Charles,8559,16621,592,186,234,26192,,
LA,St. Helena,3353,2497,43,18,53,5964,,
LA,St. James,6418,5456,98,44,69,12085,,
LA,St. John The Baptist,12661,7569,228,122,163,20743,,
LA,St. Landry,17209,21971,350,181,266,39977,,
LA,St. Martin,8266,16873,303,121,187,25750,,
LA,St. Mary,8050,14359,245,85,138,22877,,
LA,St. Tammany,27717,90915,3409,1019,1332,124392,,
LA,Tangipahoa,16878,33959,843,286,450,52416,,
LA,Tensas,1332,1182,13,8,13,2548,,
LA,Terrebonne,10665,31902,808,215,306,43896,,
LA,Union,2691,7972,108,32,91,10894,,
LA,Vermilion,4857,20063,396,116,200,25632,,
LA,Vernon,2665,13471,265,72,160,16633,,
LA,Washington,5692,12556,185,68,127,18628,,
LA,Webster,6260,11542,166,63,114,18145,,
LA,West Baton Rouge,5383,6927,206,72,124,12712,,
LA,West Carroll,715,3970,27,10,37,4759,,
LA,West Feliciana,2248,3390,97,17,47,5799,,
LA,Winn,1644,4608,40,29,51,6372,,
MA,Abington,4115,4017,417,102,261,8912,,
MA,Acton,9198,2555,552,208,454,12967,,
MA,Acushnet,2401,2834,174,87,176,5672,,
MA,Adams,2413,1285,189,80,113,4080,,
MA,Agawam,6208,7421,651,208,389,14877,,
MA,Alford,226,52,8,8,13,307,,
MA,Amesbury,5174,3231,527,151,319,9402,,
MA,Amherst,12357,1248,445,613,403,15066,,
MA,Andover,11222,6522,895,202,731,19572,,
MA,Aquinnah,232,34,6,7,8,287,,
MA,Arlington,20539,4652,732,457,891,27271,,
MA,Ashburnham,1439,1522,247,66,125,3399,,
MA,Ashby,722,974,129,45,63,1933,,
MA,Ashfield,836,184,52,44,39,1155,,
MA,Ashland,5684,2768,457,105,312,9326,,
MA,Athol,2076,2335,328,116,201,5056,,
MA,Attleboro,10518,8571,1032,321,439,20881,,
MA,Auburn,4496,4000,553,92,314,9455,,
MA,Avon,1254,1068,79,40,71,2512,,
MA,Ayer,2162,1498,292,65,159,4176,,
MA,Barnstable,13005,11195,1049,348,783,26380,,
MA,Barre,1201,1429,164,58,84,2936,,
MA,Becket,571,368,37,25,46,1047,,
MA,Bedford,5085,2211,404,92,274,8066,,
MA,Belchertown,4408,3153,392,192,273,8418,,
MA,Bellingham,4033,4059,502,100,288,8982,,
MA,Belmont,10252,3106,561,237,535,14691,,
MA,Berkley,1455,1926,149,51,98,3679,,
MA,Berlin,1009,745,124,38,50,1966,,
MA,Bernardston,711,382,81,27,43,1244,,
MA,Beverly,13185,6904,1142,332,850,22413,,
MA,Billerica,10100,10319,976,264,699,22358,,
MA,Blackstone,1850,2327,254,59,133,4623,,
MA,Blandford,256,405,28,8,20,717,,
MA,Bolton,1891,1036,230,54,134,3345,,
MA,Boston,221093,38087,7025,3969,7192,277366,,
MA,Bourne,4910,5201,442,129,353,11035,,
MA,Boxborough,1987,756,159,36,131,3069,,
MA,Boxford,2454,2194,297,35,228,5208,,
MA,Boylston,1424,1125,176,35,101,2861,,
MA,Braintree,10469,8427,766,216,748,20626,,
MA,Brewster,3813,2370,297,112,223,6815,,
MA,Bridgewater,5718,6261,624,167,370,13140,,
MA,Brimfield,793,1113,117,34,69,2126,,
MA,Brockton,25593,8801,920,388,783,36485,,
MA,Brookfield,708,936,102,27,54,1827,,
MA,Brookline,24583,3175,731,398,793,29680,,
MA,Buckland,703,230,53,39,42,1067,,
MA,Burlington,7633,5434,558,123,471,14219,,
MA,Cambridge,46563,3323,1213,1032,1151,53282,,
MA,Canton,7308,4731,574,109,448,13170,,
MA,Carlisle,2302,732,192,43,122,3391,,
MA,Carver,2529,3206,364,72,196,6367,,
MA,Charlemont,407,228,40,25,35,735,,
MA,Charlton,2709,3856,461,99,216,7341,,
MA,Chatham,2398,1796,216,68,165,4643,,
MA,Chelmsford,10705,7661,1093,237,746,20442,,
MA,Chelsea,7500,1587,207,127,612,10033,,
MA,Cheshire,978,741,83,30,59,1891,,
MA,Chester,238,372,55,13,18,696,,
MA,Chesterfield,398,267,39,39,25,768,,
MA,Chicopee,12338,9841,1046,472,844,24541,,
MA,Chilmark,617,94,30,23,24,788,,
MA,Clarksburg,510,327,29,12,18,896,,
MA,Clinton,3767,2748,396,100,226,7237,,
MA,Cohasset,2895,1629,244,46,226,5040,,
MA,Colrain,513,257,59,62,43,934,,
MA,Concord,8460,1951,503,150,383,11447,,
MA,Conway,865,249,47,39,35,1235,,
MA,Cummington,334,156,31,33,13,567,,
MA,Dalton,2190,940,166,83,104,3483,,
MA,Danvers,7752,6484,691,179,500,15606,,
MA,Dartmouth,8586,6738,610,235,434,16603,,
MA,Dedham,8621,4778,570,149,508,14626,,
MA,Deerfield,1968,777,161,75,114,3095,,
MA,Dennis,4887,3751,372,138,284,9432,,
MA,Dighton,1602,2149,172,67,132,4122,,
MA,Douglas,1780,2685,299,64,147,4975,,
MA,Dover,2063,1137,266,29,177,3672,,
MA,Dracut,6645,8319,821,187,465,16437,,
MA,Dudley,2113,2871,295,69,139,5487,,
MA,Dunstable,954,837,140,26,78,2035,,
MA,Duxbury,5137,3888,531,112,428,10096,,
MA,E. Bridgewater,3174,4073,430,86,252,8015,,
MA,E. Brookfield,417,664,65,18,53,1217,,
MA,E. Longmeadow,4089,4441,402,115,288,9335,,
MA,Eastham,2203,1199,134,61,105,3702,,
MA,Easthampton,6213,2599,367,305,312,9796,,
MA,Easton,6556,5231,623,134,467,13011,,
MA,Edgartown,1787,779,99,53,92,2810,,
MA,Egremont,621,147,30,30,17,845,,
MA,Erving,420,300,59,32,23,834,,
MA,Essex,1272,758,166,34,74,2304,,
MA,Everett,9461,3940,309,165,348,14223,,
MA,Fairhaven,4264,3824,317,133,215,8753,,
MA,Fall River,17467,10850,943,501,1062,30823,,
MA,Falmouth,11467,7165,728,273,641,20274,,
MA,Fitchburg,8590,5587,812,259,431,15679,,
MA,Florida,191,170,17,11,11,400,,
MA,Foxborough,5132,4161,580,95,376,10344,,
MA,Framingham,20520,7063,1196,347,902,30028,,
MA,Franklin,9527,6996,988,172,750,18433,,
MA,Freetown,2035,2649,178,68,147,5077,,
MA,Gardner,4196,3542,590,157,277,8762,,
MA,Georgetown,2347,2228,331,49,147,5102,,
MA,Gill,579,259,57,32,26,953,,
MA,Gloucester,9808,5355,696,280,569,16708,,
MA,Goshen,364,213,28,15,18,638,,
MA,Gosnold,36,27,2,0,6,71,,
MA,Grafton,5372,3883,586,130,316,10287,,
MA,Granby,1651,1699,173,93,125,3741,,
MA,Granville,335,548,55,20,28,986,,
MA,Great Barrington,2880,580,103,128,73,3764,,
MA,Greenfield,5574,2098,372,309,344,8697,,
MA,Groton,3917,2138,400,96,261,6812,,
MA,Groveland,1822,1934,190,52,127,4125,,
MA,Hadley,2149,867,105,98,94,3313,,
MA,Halifax,1794,2312,228,58,127,4519,,
MA,Hamilton,2631,1476,318,69,268,4762,,
MA,Hampden,1188,1645,154,37,93,3117,,
MA,Hancock,189,159,24,9,16,397,,
MA,Hanover,3750,4267,400,71,350,8838,,
MA,Hanson,2432,3124,329,58,215,6158,,
MA,Hardwick,568,709,77,28,39,1421,,
MA,Harvard,2515,889,182,50,140,3776,,
MA,Harwich,4560,3294,340,132,246,8572,,
MA,Hatfield,1284,660,77,61,70,2152,,
MA,Haverhill,15407,12050,1343,418,911,30129,,
MA,Hawley,105,67,14,7,13,206,,
MA,Heath,244,165,24,12,14,459,,
MA,Hingham,8510,4810,691,142,702,14855,,
MA,Hinsdale,606,403,55,37,35,1136,,
MA,Holbrook,2912,2385,248,90,164,5799,,
MA,Holden,5605,4612,661,149,413,11440,,
MA,Holland,475,720,106,33,47,1381,,
MA,Holliston,5291,2563,458,92,363,8767,,
MA,Holyoke,11656,4022,509,392,460,17039,,
MA,Hopedale,1759,1375,197,49,131,3511,,
MA,Hopkinton,5358,2911,560,100,407,9336,,
MA,Hubbardston,1040,1376,203,36,110,2765,,
MA,Hudson,6028,3775,599,118,345,10865,,
MA,Hull,3688,2356,253,66,180,6543,,
MA,Huntington,460,611,71,35,24,1201,,
MA,Ipswich,4939,3013,459,138,297,8846,,
MA,Kingston,3471,3579,381,84,219,7734,,
MA,Lakeville,2466,3374,315,86,263,6504,,
MA,Lancaster,1850,1651,284,59,165,4009,,
MA,Lanesborough,998,597,77,32,43,1747,,
MA,Lawrence,19852,3535,476,220,454,24537,,
MA,Lee,1969,852,115,86,77,3099,,
MA,Leicester,2423,2825,318,72,190,5828,,
MA,Lenox,2234,572,116,70,104,3096,,
MA,Leominster,9840,8199,1076,262,574,19951,,
MA,Leverett,996,185,24,56,35,1296,,
MA,Lexington,13900,3279,610,244,558,18591,,
MA,Leyden,306,139,23,20,14,502,,
MA,Lincoln,2996,625,178,49,109,3957,,
MA,Littleton,3445,1876,393,56,231,6001,,
MA,Longmeadow,5311,3457,412,128,326,9634,,
MA,Lowell,23555,10584,1437,552,1218,37346,,
MA,Ludlow,4483,5097,410,144,307,10441,,
MA,Lunenburg,2942,2802,386,79,231,6440,,
MA,Lynn,22164,9311,925,430,1359,34189,,
MA,Lynnfield,3238,3829,297,72,257,7693,,
MA,Malden,15845,5538,641,335,636,22995,,
MA,Manchester-by-the-Sea,2249,954,227,34,159,3623,,
MA,Mansfield,6879,5073,697,142,550,13341,,
MA,Marblehead,8111,3759,665,117,506,13158,,
MA,Marion,1861,1159,151,49,103,3323,,
MA,Marlborough,10577,5959,918,225,657,18336,,
MA,Marshfield,7343,7215,697,181,484,15920,,
MA,Mashpee,4448,3839,347,119,231,8984,,
MA,Mattapoisett,2125,1820,163,52,154,4314,,
MA,Maynard,3860,1671,303,77,179,6090,,
MA,Medfield,4409,2400,427,61,502,7799,,
MA,Medford,20690,7671,897,378,892,30528,,
MA,Medway,4009,2948,458,67,318,7800,,
MA,Melrose,10687,4832,678,172,592,16961,,
MA,Mendon,1530,1694,214,30,116,3584,,
MA,Merrimac,1895,1622,226,57,135,3935,,
MA,Methuen,11662,10235,811,236,640,23584,,
MA,Middleborough,4837,6583,676,164,395,12655,,
MA,Middlefield,155,115,16,10,11,307,,
MA,Middleton,2159,2663,192,33,164,5211,,
MA,Milford,7370,5237,601,159,459,13826,,
MA,Millbury,3162,3445,394,83,204,7288,,
MA,Millis,2620,1890,309,58,173,5050,,
MA,Millville,624,874,103,28,43,1672,,
MA,Milton,10752,4286,595,149,580,16362,,
MA,Monroe,25,26,5,2,1,59,,
MA,Monson,1922,2259,245,108,146,4680,,
MA,Montague,2858,1095,213,181,144,4491,,
MA,Monterey,417,88,20,12,17,554,,
MA,Montgomery,199,281,32,12,6,530,,
MA,Mount Washington,76,19,5,4,3,107,,
MA,N. Adams,3730,1570,241,172,166,5879,,
MA,N. Andover,8499,6391,801,119,581,16391,,
MA,N. Attleborough,7059,6716,863,226,570,15434,,
MA,N. Brookfield,907,1413,160,36,75,2591,,
MA,N. Reading,4283,3986,470,87,328,9154,,
MA,Nahant,1347,864,87,23,57,2378,,
MA,Nantucket,4146,1892,260,108,177,6583,,
MA,Natick,13420,4870,853,222,732,20097,,
MA,Needham,12797,4019,746,150,760,18472,,
MA,New Ashford,101,39,14,6,1,161,,
MA,New Bedford,20812,10327,955,586,928,33608,,
MA,New Braintree,246,326,22,18,11,623,,
MA,New Marlborough,564,218,34,35,20,871,,
MA,New Salem,337,208,28,22,19,614,,
MA,Newbury,2465,1716,215,63,164,4623,,
MA,Newburyport,7385,3114,520,140,425,11584,,
MA,Newton,36463,7764,1466,514,1262,47469,,
MA,Norfolk,2956,2458,391,60,277,6142,,
MA,Northampton,13512,1878,341,638,626,16995,,
MA,Northborough,5130,2964,523,104,345,9066,,
MA,Northbridge,3425,3977,574,104,327,8407,,
MA,Northfield,1013,533,91,50,70,1757,,
MA,Norton,4555,4428,496,113,449,10041,,
MA,Norwell,3277,2837,322,56,274,6766,,
MA,Norwood,9000,5692,656,184,584,16116,,
MA,Oak Bluffs,2098,738,87,44,82,3049,,
MA,Oakham,435,633,72,19,25,1184,,
MA,Orange,1487,1550,222,78,98,3435,,
MA,Orleans,2687,1511,192,65,140,4595,,
MA,Otis,431,407,43,18,25,924,,
MA,Oxford,2744,3576,405,83,217,7025,,
MA,Palmer,2475,3083,322,148,165,6193,,
MA,Paxton,1213,1197,151,38,109,2708,,
MA,Peabody,14395,12036,962,262,894,28549,,
MA,Pelham,748,98,25,22,22,915,,
MA,Pembroke,4630,4913,588,123,362,10616,,
MA,Pepperell,2932,3098,455,84,277,6846,,
MA,Peru,255,207,34,8,15,519,,
MA,Petersham,417,312,46,19,33,827,,
MA,Phillipston,374,550,67,13,26,1030,,
MA,Pittsfield,13907,4771,763,515,522,20478,,
MA,Plainfield,263,107,13,18,18,419,,
MA,Plainville,2216,2223,305,68,172,4984,,
MA,Plymouth,15602,14309,1597,422,1093,33023,,
MA,Plympton,727,883,114,28,56,1808,,
MA,Princeton,1183,898,124,35,105,2345,,
MA,Provincetown,2082,208,38,35,36,2399,,
MA,Quincy,25477,13321,1460,557,1377,42192,,
MA,Randolph,11509,3098,335,159,305,15406,,
MA,Raynham,3327,3806,364,77,240,7814,,
MA,Reading,8848,5373,681,142,561,15605,,
MA,Rehoboth,2784,3574,322,110,187,6977,,
MA,Revere,11964,6895,446,239,537,20081,,
MA,Richmond,706,218,28,26,27,1005,,
MA,Rochester,1368,1743,161,50,112,3434,,
MA,Rockland,4403,4313,464,115,266,9561,,
MA,Rockport,3122,1371,225,79,179,4976,,
MA,Rowe,122,99,7,7,6,241,,
MA,Rowley,1679,1809,221,53,143,3905,,
MA,Royalston,314,321,32,16,19,702,,
MA,Russell,278,480,50,13,27,848,,
MA,Rutland,2022,2344,328,73,181,4948,,
MA,S. Hadley,5208,3254,383,180,313,9338,,
MA,Salem,14950,5458,750,401,624,22183,,
MA,Salisbury,2098,2249,216,71,176,4810,,
MA,Sandisfield,254,190,22,12,10,488,,
MA,Sandwich,6017,5846,510,143,407,12923,,
MA,Saugus,6385,7305,414,146,468,14718,,
MA,Savoy,184,163,24,11,19,401,,
MA,Scituate,6512,4457,542,146,458,12115,,
MA,Seekonk,3663,3572,322,106,214,7877,,
MA,Sharon,7219,2447,404,124,334,10528,,
MA,Sheffield,1242,530,80,46,44,1942,,
MA,Shelburne,821,230,49,51,46,1197,,
MA,Sherborn,1766,617,197,23,120,2723,,
MA,Shirley,1637,1432,214,49,118,3450,,
MA,Shrewsbury,10620,6808,894,197,688,19207,,
MA,Shutesbury,980,142,38,83,39,1282,,
MA,Somerset,4901,4566,330,169,311,10277,,
MA,Somerville,33740,4128,1109,841,1056,40874,,
MA,Southampton,1744,1692,193,64,148,3841,,
MA,Southborough,3530,1898,328,56,271,6083,,
MA,Southbridge,3714,2586,374,110,197,6981,,
MA,Southwick,1859,2961,267,73,167,5327,,
MA,Spencer,2265,3045,296,83,186,5875,,
MA,Springfield,40341,11231,1409,820,1385,55186,,
MA,Sterling,2162,2327,344,64,169,5066,,
MA,Stockbridge,965,252,29,30,29,1305,,
MA,Stoneham,6962,5243,525,110,453,13293,,
MA,Stoughton,8451,4920,542,162,473,14548,,
MA,Stow,2708,1261,286,70,162,4487,,
MA,Sturbridge,2534,2415,320,89,164,5522,,
MA,Sudbury,7402,2510,473,86,469,10940,,
MA,Sunderland,1353,387,82,62,64,1948,,
MA,Sutton,2312,2881,313,61,181,5748,,
MA,Swampscott,5554,2586,336,100,309,8885,,
MA,Swansea,3928,4351,285,103,206,8873,,
MA,Taunton,12365,9973,1042,362,738,24480,,
MA,Templeton,1521,2068,272,59,138,4058,,
MA,Tewksbury,7602,8432,843,183,548,17608,,
MA,Tisbury,1942,476,72,83,81,2654,,
MA,Tolland,101,190,8,8,12,319,,
MA,Topsfield,2100,1566,214,34,300,4214,,
MA,Townsend,2082,2550,361,76,161,5230,,
MA,Truro,1095,361,62,33,38,1589,,
MA,Tyngsborough,3061,3167,364,79,174,6845,,
MA,Tyringham,201,70,13,0,15,299,,
MA,Upton,2296,1818,327,56,179,4676,,
MA,Uxbridge,3266,3698,492,93,249,7798,,
MA,W. Boylston,2136,1838,233,56,159,4422,,
MA,W. Bridgewater,1623,2150,227,51,160,4211,,
MA,W. Brookfield,869,1008,111,40,69,2097,,
MA,W. Newbury,1620,1020,188,26,134,2988,,
MA,W. Springfield,5711,5537,589,208,383,12428,,
MA,W. Stockbridge,659,178,28,16,20,901,,
MA,W. Tisbury,1688,329,70,49,56,2192,,
MA,Wakefield,8294,6060,677,160,627,15818,,
MA,Wales,365,550,52,21,29,1017,,
MA,Walpole,7270,6046,755,135,622,14828,,
MA,Waltham,17355,7592,962,370,450,26729,,
MA,Ware,1853,2189,243,77,174,4536,,
MA,Wareham,5435,5104,500,176,318,11533,,
MA,Warren,904,1266,142,39,61,2412,,
MA,Warwick,271,142,25,19,17,474,,
MA,Washington,217,89,9,5,7,327,,
MA,Watertown,13166,3941,629,323,609,18668,,
MA,Wayland,6114,1684,374,98,338,8608,,
MA,Webster,3119,3575,406,103,208,7411,,
MA,Wellesley,10568,3235,666,121,676,15266,,
MA,Wellfleet,1554,515,73,73,67,2282,,
MA,Wendell,402,104,21,48,16,591,,
MA,Wenham,1368,774,192,24,120,2478,,
MA,Westborough,6023,2752,486,138,377,9776,,
MA,Westfield,8225,9021,1034,337,689,19306,,
MA,Westford,7854,4706,824,160,527,14071,,
MA,Westhampton,629,408,46,27,26,1136,,
MA,Westminster,1958,2165,276,68,156,4623,,
MA,Weston,4368,1648,332,57,291,6696,,
MA,Westport,4383,4285,306,98,271,9343,,
MA,Westwood,5319,3218,460,93,404,9494,,
MA,Weymouth,15398,11983,1159,380,947,29867,,
MA,Whately,582,328,55,30,35,1030,,
MA,Whitman,3393,3815,457,98,298,8061,,
MA,Wilbraham,3744,4010,369,104,385,8612,,
MA,Williamsburg,1207,347,69,58,33,1714,,
MA,Williamstown,2916,478,83,59,87,3623,,
MA,Wilmington,6205,6167,612,125,486,13595,,
MA,Winchendon,1789,2312,292,91,134,4618,,
MA,Winchester,8062,3701,584,128,513,12988,,
MA,Windsor,313,159,36,11,17,536,,
MA,Winthrop,5194,3852,318,130,233,9727,,
MA,Woburn,10915,8342,791,211,631,20890,,
MA,Worcester,43084,17732,2410,1172,1905,66303,,
MA,Worthington,430,229,41,46,17,763,,
MA,Wrentham,3052,2993,390,79,290,6804,,
MA,Yarmouth,7304,5848,537,190,408,14287,,
MD,Allegany,7875,21270,858,365,286,30654,,
MD,Anne Arundel,128419,122403,10408,3316,5535,270081,,
MD,Baltimore,218412,149477,11748,5338,5707,390682,,
MD,Baltimore City,202673,25205,4568,4087,2869,239402,,
MD,Calvert,18225,26176,1815,498,694,47408,,
MD,Caroline,4009,9368,445,129,162,14113,,
MD,Carroll,26567,58215,4286,1060,1720,91848,,
MD,Cecil,13650,28868,1665,568,518,45269,,
MD,Charles,49341,25614,1696,769,883,78303,,
MD,Dorchester,6245,8413,337,109,121,15225,,
MD,Frederick,56522,59522,5427,1745,2461,125677,,
MD,Garrett,2567,10776,400,107,161,14011,,
MD,Harford,47077,77860,5060,1596,2079,133672,,
MD,Howard,102597,47484,6282,2294,3536,162193,,
MD,Kent,4575,4876,312,116,142,10021,,
MD,Montgomery,357837,92704,11513,6620,10199,478873,,
MD,Prince George's,344049,32811,4557,4723,4245,390385,,
MD,Queen Anne's,7973,16993,940,272,345,26523,,
MD,Somerset,4196,5341,190,64,109,9900,,
MD,St. Mary's,17534,28663,2270,507,868,49842,,
MD,Talbot,8653,10724,632,203,341,20553,,
MD,Washington,21129,40998,2164,778,922,65991,,
MD,Wicomico,18050,22198,1297,432,570,42547,,
MD,Worcester,9753,17210,735,249,326,28273,,
ME,ABBOT,101,255,31,10,11,408,,
ME,ACTON,542,820,68,23,44,1497,,
ME,ADDISON,210,409,36,10,15,680,,
ME,ALBANY TWP,106,152,33,13,11,315,,
ME,ALBION,329,716,65,27,38,1175,,
ME,ALEXANDER,80,208,7,5,13,313,,
ME,ALFRED,812,885,92,24,60,1873,,
ME,ALLAGASH,69,85,3,2,10,169,,
ME,ALNA,262,176,15,14,15,482,,
ME,ALTON,153,273,33,5,9,473,,
ME,AMHERST,57,99,7,6,5,174,,
ME,AMITY,29,82,4,2,7,124,,
ME,ANDOVER,195,280,40,13,18,546,,
ME,ANSON,360,705,57,20,33,1175,,
ME,APPLETON,393,396,41,16,28,874,,
ME,ARGYLE TOWNSHIP,34,47,2,1,2,86,,
ME,ARROWSIC,222,98,9,10,12,351,,
ME,ARUNDEL,1064,1198,141,43,90,2536,,
ME,ASHLAND,208,347,40,11,22,628,,
ME,ATHENS,160,275,32,13,21,501,,
ME,ATKINSON,50,120,10,1,7,188,,
ME,AUBURN,5296,5325,737,207,421,11986,,
ME,AUGUSTA,4396,3805,501,192,320,9214,,
ME,AURORA,17,48,5,3,3,76,,
ME,AVON,76,146,15,4,7,248,,
ME,BAILEYVILLE,263,372,43,8,21,707,,
ME,BALDWIN,271,560,58,16,31,936,,
ME,BANGOR,8155,6001,868,310,578,15912,,
ME,BAR HARBOR,2244,712,107,58,96,3217,,
ME,BARING PLT,48,66,4,1,8,127,,
ME,BARNARD TWP/EBEEMEE TWP/T4 R9 NWP/WILLIAMSBURG TWP,32,55,11,2,4,104,,
ME,BATH,2717,1571,252,115,168,4823,,
ME,BEALS,113,141,18,6,10,288,,
ME,BEAVER COVE,37,58,4,0,2,101,,
ME,BEDDINGTON,11,24,1,1,0,37,,
ME,BELFAST,2351,1241,177,100,129,3998,,
ME,BELGRADE,826,1062,89,18,54,2049,,
ME,BELMONT,225,281,35,12,24,577,,
ME,BENTON,544,842,101,20,59,1566,,
ME,BERRY TWP/CATHANCE TWP/MARION TWP,12,17,2,0,2,33,,
ME,BERWICK,1539,2086,207,58,115,4005,,
ME,BETHEL,856,678,102,20,56,1712,,
ME,BIDDEFORD,5505,3729,471,241,367,10313,,
ME,BIG TWENTY TWP/T15 R15 WELS,0,2,0,0,0,2,,
ME,BINGHAM,191,302,16,14,21,544,,
ME,BLAINE,94,283,13,2,7,399,,
ME,BLUE HILL,1088,560,82,44,50,1824,,
ME,BOOTHBAY,980,899,112,40,82,2113,,
ME,BOOTHBAY HARBOR,729,541,64,22,37,1393,,
ME,BOWDOIN,589,1007,81,21,66,1764,,
ME,BOWDOINHAM,876,803,109,41,56,1885,,
ME,BOWERBANK,25,60,3,0,5,93,,
ME,BRADFORD,185,442,26,8,18,679,,
ME,BRADLEY,335,411,42,15,31,834,,
ME,BREMEN,282,194,11,6,20,513,,
ME,BREWER,2165,2585,302,92,160,5304,,
ME,BRIDGEWATER,85,202,17,5,4,313,,
ME,BRIDGTON,1224,1474,158,69,102,3027,,
ME,BRIGHTON PLT,12,32,2,2,1,49,,
ME,BRISTOL,936,767,73,35,83,1894,,
ME,BROOKLIN,346,177,20,16,15,574,,
ME,BROOKS,207,298,32,21,23,581,,
ME,BROOKSVILLE,406,190,15,21,25,657,,
ME,BROWNFIELD,366,428,42,11,31,878,,
ME,BROWNVILLE,211,332,37,13,18,611,,
ME,BRUNSWICK,7992,3647,579,236,438,12892,,
ME,BUCKFIELD,371,619,58,19,45,1112,,
ME,BUCKSPORT,1035,1335,148,47,90,2655,,
ME,BURLINGTON,41,131,10,6,6,194,,
ME,BURNHAM,213,404,35,13,24,689,,
ME,BUXTON,1895,2538,237,82,146,4898,,
ME,BYRON,29,52,3,5,4,93,,
ME,CALAIS,574,762,90,16,63,1505,,
ME,CAMBRIDGE,65,173,18,5,8,269,,
ME,CAMDEN,2430,802,80,60,131,3503,,
ME,CANAAN,362,647,78,27,42,1156,,
ME,CANTON,152,242,37,76,32,539,,
ME,CAPE ELIZABETH,4480,1593,229,70,226,6598,,
ME,CARATUNK,27,23,0,0,0,50,,
ME,CARIBOU,1595,2106,213,45,130,4089,,
ME,CARMEL,459,1019,79,20,55,1632,,
ME,CARRABASSETT VALLEY,264,127,32,23,28,474,,
ME,CARROLL PLT,17,72,2,3,1,95,,
ME,CARTHAGE,90,139,20,33,10,292,,
ME,CARY PLT,24,81,6,1,6,118,,
ME,CASCO,819,1117,104,46,69,2155,,
ME,CASTINE,329,205,37,8,21,600,,
ME,CASTLE HILL,85,123,11,3,12,234,,
ME,CASWELL,73,58,6,4,8,149,,
ME,CATHANCE TWP,5,6,0,0,0,11,,
ME,CENTERVILLE TWP,4,13,0,0,1,18,,
ME,CHAPMAN,99,156,15,5,4,279,,
ME,CHARLESTON,140,532,20,9,15,716,,
ME,CHARLOTTE,51,114,4,6,10,185,,
ME,CHEBEAGUE ISLAND,232,66,17,11,3,329,,
ME,CHELSEA,520,860,63,26,58,1527,,
ME,CHERRYFIELD,200,366,38,20,27,651,,
ME,CHESTER,65,244,14,4,5,332,,
ME,CHESTERVILLE,276,375,60,15,21,747,,
ME,CHINA,919,1347,135,42,73,2516,,
ME,CLIFTON,170,293,30,11,14,518,,
ME,CLINTON,521,1012,86,29,59,1707,,
ME,COLUMBIA,43,151,9,4,13,220,,
ME,COLUMBIA FALLS,82,190,14,7,9,302,,
ME,CONCORD TOWNSHIP,0,3,0,0,0,3,,
ME,COOPER,33,55,3,2,2,95,,
ME,COPLIN PLT,38,44,11,3,7,103,,
ME,CORINNA,304,738,61,22,36,1161,,
ME,CORINTH,368,1057,60,9,37,1531,,
ME,CORNISH,332,397,64,18,25,836,,
ME,CORNVILLE,251,410,36,16,19,732,,
ME,CRANBERRY ISLES,100,41,6,4,2,153,,
ME,CRAWFORD,21,48,2,1,1,73,,
ME,CRIEHAVEN TOWNSHIP,1,0,0,0,0,1,,
ME,CROSS LAKE TWP (T17 R5),53,55,9,2,2,121,,
ME,CRYSTAL,33,102,8,3,3,149,,
ME,CUMBERLAND,3184,1755,283,55,228,5505,,
ME,CUSHING,372,440,34,12,24,882,,
ME,CUTLER,70,202,7,6,12,297,,
ME,CYR PLT,22,28,1,0,2,53,,
ME,DALLAS PLT,90,92,15,4,6,207,,
ME,DAMARISCOTTA,767,454,70,23,58,1372,,
ME,DANFORTH,92,243,20,5,13,373,,
ME,DAYTON,467,668,72,23,40,1270,,
ME,DEBLOIS,6,30,1,1,1,39,,
ME,DEDHAM,450,542,57,20,31,1100,,
ME,DEER ISLE,684,453,43,21,29,1230,,
ME,DENMARK,285,382,40,21,24,752,,
ME,DENNISTOWN PLT,5,19,0,0,2,26,,
ME,DENNYSVILLE,94,196,25,7,16,338,,
ME,DETROIT,147,228,19,10,11,415,,
ME,DEXTER,572,1062,103,38,54,1829,,
ME,DIXFIELD,415,709,90,24,68,1306,,
ME,DIXMONT,232,431,31,20,32,746,,
ME,DOVER-FOXCROFT,789,1138,111,58,80,2176,,
ME,DRESDEN,447,513,63,20,46,1089,,
ME,DREW PLT,3,20,1,0,0,24,,
ME,DURHAM,1084,1266,147,43,71,2611,,
ME,DYER BROOK,38,96,9,4,3,150,,
ME,E TWP,5,28,1,1,0,35,,
ME,EAGLE LAKE,218,231,16,3,15,483,,
ME,EAST MACHIAS,245,424,27,15,16,727,,
ME,EAST MILLINOCKET,373,494,37,17,29,950,,
ME,EASTBROOK,66,150,16,6,6,244,,
ME,EASTON,217,408,28,15,21,689,,
ME,EASTPORT,408,309,24,39,35,815,,
ME,EDDINGTON,444,784,86,20,33,1367,,
ME,EDGECOMB,422,321,47,14,19,823,,
ME,EDINBURG,26,47,0,1,1,75,,
ME,ELIOT,2257,1704,200,58,134,4353,,
ME,ELLIOTTSVILLE TWP,7,6,1,1,1,16,,
ME,ELLSWORTH,1810,2113,242,90,146,4401,,
ME,EMBDEN,167,322,23,10,13,535,,
ME,ENFIELD,259,493,56,9,36,853,,
ME,ETNA,198,385,35,16,23,657,,
ME,EUSTIS,136,222,37,12,18,425,,
ME,EXETER,177,330,28,6,9,550,,
ME,FAIRFIELD,1250,1745,206,56,125,3382,,
ME,FALMOUTH,4877,2633,305,107,257,8179,,
ME,FARMINGDALE,773,761,96,32,61,1723,,
ME,FARMINGTON,1979,1483,260,104,157,3983,,
ME,FAYETTE,344,373,40,10,22,789,,
ME,FORT FAIRFIELD,659,888,70,13,74,1704,,
ME,FORT KENT,986,997,95,30,79,2187,,
ME,FRANKFORT,220,381,34,14,22,671,,
ME,FRANKLIN,303,426,48,11,23,811,,
ME,FREEDOM,172,209,32,12,15,440,,
ME,FREEPORT,3442,1644,265,86,178,5615,,
ME,FRENCHBORO,7,23,0,2,1,33,,
ME,FRENCHVILLE,264,312,22,8,20,626,,
ME,FRIENDSHIP,271,425,31,13,18,758,,
ME,FRYE ISLAND,43,26,8,0,1,78,,
ME,FRYEBURG,810,768,134,38,83,1833,,
ME,GARDINER,1446,1361,156,80,77,3120,,
ME,GARFIELD PLT,14,31,4,1,3,53,,
ME,GARLAND,167,344,34,7,25,577,,
ME,GEORGETOWN,402,281,29,32,25,769,,
ME,GILEAD,42,62,10,2,2,118,,
ME,GLENBURN,933,1411,143,34,85,2606,,
ME,GLENWOOD PLT,0,2,0,0,0,2,,
ME,GORHAM,4995,3945,486,161,360,9947,,
ME,GOULDSBORO,409,559,39,11,16,1034,,
ME,GRAND FALLS TOWNSHIP,1,2,2,2,0,7,,
ME,GRAND ISLE,122,93,4,4,10,233,,
ME,GRAND LAKE STREAM PLT,32,59,8,0,3,102,,
ME,GRAY,2021,2397,269,81,163,4931,,
ME,GREAT POND,15,22,3,1,0,41,,
ME,GREENBUSH,185,440,45,12,27,709,,
ME,GREENE,810,1542,150,26,69,2597,,
ME,GREENVILLE,407,625,41,11,44,1128,,
ME,GREENWOOD,213,211,27,7,16,474,,
ME,GRINDSTONE/HERSEYTOWN/SOLDIERTOWN TWP,4,18,2,0,1,25,,
ME,GUILFORD,222,401,32,20,27,702,,
ME,HALLOWELL,1093,374,71,46,75,1659,,
ME,HAMLIN,48,52,0,1,3,104,,
ME,HAMMOND,8,37,3,1,1,50,,
ME,HAMPDEN,1929,2103,272,74,154,4532,,
ME,HANCOCK,507,678,73,29,44,1331,,
ME,HANOVER,84,85,11,5,4,189,,
ME,HARMONY,154,293,17,6,23,493,,
ME,HARPSWELL,1881,1316,128,51,107,3483,,
ME,HARRINGTON,129,322,19,8,23,501,,
ME,HARRISON,568,760,80,38,51,1497,,
ME,HARTFORD,206,378,43,10,18,655,,
ME,HARTLAND,222,600,37,9,20,888,,
ME,HAYNESVILLE,11,33,2,1,3,50,,
ME,HEBRON,249,397,74,10,23,753,,
ME,HERMON,1101,2170,171,35,111,3588,,
ME,HERSEY,4,23,5,0,2,34,,
ME,HERSEYTOWN TWP,0,13,1,1,0,15,,
ME,HIGHLAND PLT,33,70,5,5,5,118,,
ME,HIRAM,312,442,49,19,35,857,,
ME,HODGDON,148,499,22,6,15,690,,
ME,HOLDEN,719,1123,102,36,70,2050,,
ME,HOLLIS,1015,1329,154,58,84,2640,,
ME,HOPE,537,418,44,20,29,1048,,
ME,HOULTON,940,1573,134,36,89,2772,,
ME,HOWLAND,248,387,28,6,29,698,,
ME,HUDSON,194,490,38,12,24,758,,
ME,INDIAN TOWNSHIP,184,59,13,1,24,281,,
ME,INDUSTRY,189,234,28,8,11,470,,
ME,ISLAND FALLS,123,249,16,11,20,419,,
ME,ISLE AU HAUT,38,15,3,7,3,66,,
ME,ISLESBORO,280,116,14,9,11,430,,
ME,JACKMAN,121,376,20,5,22,544,,
ME,JACKSON,104,189,20,6,15,334,,
ME,JAY,1143,1184,142,28,103,2600,,
ME,JEFFERSON,548,874,88,40,63,1613,,
ME,JONESBORO,119,177,23,3,19,341,,
ME,JONESPORT,240,377,34,10,27,688,,
ME,KENDUSKEAG,202,461,45,17,17,742,,
ME,KENNEBUNK,4224,2648,345,125,308,7650,,
ME,KENNEBUNKPORT,1356,910,98,30,108,2502,,
ME,KINGFIELD,297,403,65,18,27,810,,
ME,KINGMAN TWP,16,53,1,0,1,71,,
ME,KINGSBURY PLT,9,9,1,0,0,19,,
ME,KITTERY,3474,1746,264,82,182,5748,,
ME,KNOX,131,281,23,9,15,459,,
ME,LAGRANGE,112,237,9,4,8,370,,
ME,LAKE VIEW PLT,33,39,0,0,1,73,,
ME,LAKEVILLE,18,32,6,0,3,59,,
ME,LAMOINE,481,516,60,12,43,1112,,
ME,LEBANON,939,1945,165,57,92,3198,,
ME,LEE,137,358,11,8,20,534,,
ME,LEEDS,414,751,75,17,42,1299,,
ME,LEVANT,424,1025,74,15,57,1595,,
ME,LEWISTON,8222,7336,944,236,519,17257,,
ME,LEXINGTON TWP/SPRING LAKE TWP,4,14,2,1,0,21,,
ME,LIBERTY,233,267,31,13,22,566,,
ME,LIMERICK,642,843,87,36,64,1672,,
ME,LIMESTONE,325,410,37,15,25,812,,
ME,LIMINGTON,697,1195,103,36,63,2094,,
ME,LINCOLN,704,1574,124,39,92,2533,,
ME,LINCOLN PLT,8,17,1,0,3,29,,
ME,LINCOLNVILLE,883,510,78,43,60,1574,,
ME,LINNEUS,88,358,17,3,16,482,,
ME,LISBON,1697,2749,281,83,136,4946,,
ME,LITCHFIELD,701,1156,109,43,76,2085,,
ME,LITTLETON,112,356,19,7,15,509,,
ME,LIVERMORE,471,704,64,22,78,1339,,
ME,LIVERMORE FALLS,550,728,114,43,51,1486,,
ME,LONG ISLAND,109,52,7,2,6,176,,
ME,LOVELL,313,335,44,8,16,716,,
ME,LOWELL,61,155,4,9,3,232,,
ME,LUBEC,374,359,26,19,45,823,,
ME,LUDLOW,65,140,19,4,6,234,,
ME,LYMAN,1038,1300,132,62,85,2617,,
ME,MACHIAS,387,454,56,29,73,999,,
ME,MACHIASPORT,184,249,12,38,23,506,,
ME,MACWAHOC PLT,14,27,2,0,1,44,,
ME,MADAWASKA,1178,845,94,36,93,2246,,
ME,MADAWASKA LAKE TWP (T16 R4),57,47,1,1,2,108,,
ME,MADISON,813,1262,107,30,94,2306,,
ME,MAGALLOWAY PLT,2,15,0,0,1,18,,
ME,MANCHESTER,746,769,84,19,61,1679,,
ME,MAPLETON,359,693,57,13,33,1155,,
ME,MARIAVILLE,91,165,20,4,12,292,,
ME,MARS HILL,193,518,28,8,35,782,,
ME,MARSHFIELD,101,185,13,6,12,317,,
ME,MASARDIS,44,79,3,2,2,130,,
ME,MATINICUS ISLE PLT,33,18,0,0,2,53,,
ME,MATTAMISCONTIS TOWNSHIP,1,40,1,0,0,42,,
ME,MATTAWAMKEAG,105,222,17,7,11,362,,
ME,MAXFIELD,17,36,3,2,0,58,,
ME,MECHANIC FALLS,515,871,117,24,59,1586,,
ME,MEDDYBEMPS,30,62,5,1,7,105,,
ME,MEDFORD,44,96,5,3,4,152,,
ME,MEDWAY,193,508,23,7,20,751,,
ME,MERCER,158,225,16,8,17,424,,
ME,MERRILL,37,82,11,3,4,137,,
ME,MEXICO,544,647,85,28,58,1362,,
ME,MILBRIDGE,266,361,32,8,28,695,,
ME,MILFORD,783,809,109,31,48,1780,,
ME,MILLINOCKET,913,1161,101,32,78,2285,,
ME,MILLINOCKET PENOBSCOT TOWNSHIPS,62,63,4,1,6,136,,
ME,MILLINOCKET PISCATAQUS TOWNSHIPS,14,52,0,0,1,67,,
ME,MILO,385,696,55,22,81,1239,,
ME,MILTON TWP,26,53,4,2,3,88,,
ME,MINOT,539,981,100,22,41,1683,,
ME,MOLUNKUS TWP,19,29,0,0,0,48,,
ME,MONHEGAN ISLAND PLT,40,6,2,9,3,60,,
ME,MONMOUTH,865,1271,166,36,74,2412,,
ME,MONROE,247,246,32,17,19,561,,
ME,MONSON,159,255,17,10,17,458,,
ME,MONTICELLO,96,296,8,6,19,425,,
ME,MONTVILLE,288,279,28,30,22,647,,
ME,MOOSE RIVER,15,94,5,1,4,119,,
ME,MORO PLT,1,25,0,0,1,27,,
ME,MORRILL,192,296,29,6,28,551,,
ME,MOSCOW,88,155,3,8,9,263,,
ME,MOUNT CHASE,23,71,4,2,7,107,,
ME,MOUNT DESERT,917,389,54,21,55,1436,,
ME,MOUNT VERNON,458,475,63,27,41,1064,,
ME,NAPLES,826,1277,118,39,73,2333,,
ME,NASHVILLE PLT,7,12,1,0,0,20,,
ME,NEW CANADA,68,85,4,4,3,164,,
ME,NEW GLOUCESTER,1350,1657,167,61,129,3364,,
ME,NEW LIMERICK,97,224,11,2,13,347,,
ME,NEW PORTLAND,153,226,29,19,15,442,,
ME,NEW SHARON,310,498,69,31,34,942,,
ME,NEW SWEDEN,147,185,24,8,13,377,,
ME,NEW VINEYARD,130,256,29,7,28,450,,
ME,NEWBURGH,328,546,41,14,37,966,,
ME,NEWCASTLE,786,380,43,15,46,1270,,
ME,NEWFIELD,285,501,43,13,30,872,,
ME,NEWPORT,576,1026,86,31,51,1770,,
ME,NEWRY,136,109,14,10,13,282,,
ME,NOBLEBORO,548,518,45,26,39,1176,,
ME,NORRIDGEWOCK,636,1022,92,32,58,1840,,
ME,NORTH BERWICK,1165,1419,153,66,94,2897,,
ME,NORTH HAVEN,189,67,18,11,16,301,,
ME,NORTH YARMOUTH,1493,922,118,35,88,2656,,
ME,NORTHFIELD,38,65,2,2,1,108,,
ME,NORTHPORT,528,408,48,16,37,1037,,
ME,NORWAY,1056,1313,152,36,136,2693,,
ME,OAKFIELD,102,254,16,7,13,392,,
ME,OAKLAND,1442,1715,232,64,143,3596,,
ME,OGUNQUIT,564,286,24,10,37,921,,
ME,OLD ORCHARD BEACH,2978,2147,223,86,165,5599,,
ME,OLD TOWN,2029,1514,245,90,137,4015,,
ME,ORIENT,13,69,1,1,5,89,,
ME,ORLAND,623,651,72,31,25,1402,,
ME,ORONO,3420,1445,364,115,212,5556,,
ME,ORRINGTON,869,1313,131,38,64,2415,,
ME,OSBORN,14,26,1,0,0,41,,
ME,OTIS,137,260,25,3,24,449,,
ME,OTISFIELD,423,560,60,22,29,1094,,
ME,OWLS HEAD,496,431,35,36,40,1038,,
ME,OXBOW PLT,10,25,1,1,1,38,,
ME,OXFORD,694,1270,150,39,77,2230,,
ME,PALERMO,308,467,60,18,37,890,,
ME,PALMYRA,309,681,54,20,25,1089,,
ME,PARIS,1034,1372,177,55,114,2752,,
ME,PARKMAN,151,283,38,3,23,498,,
ME,PARSONSFIELD,367,552,59,22,27,1027,,
ME,PASSADUMKEAG,37,165,10,3,9,224,,
ME,PATTEN,138,322,20,7,24,511,,
ME,PEMBROKE,191,273,15,12,9,500,,
ME,PENOBSCOT,445,279,29,29,28,810,,
ME,PENOBSCOT NATION VOTING DISTRICT,198,43,10,20,13,284,,
ME,PERHAM,60,119,9,7,12,207,,
ME,PERKINS TOWNSHIP,8,4,1,0,0,13,,
ME,PERRY,171,266,17,5,12,471,,
ME,PERU,321,547,63,10,37,978,,
ME,PHILLIPS,230,344,34,14,27,649,,
ME,PHIPPSBURG,617,692,67,27,37,1440,,
ME,PITTSFIELD,670,1072,126,40,72,1980,,
ME,PITTSTON,577,936,101,29,80,1723,,
ME,PLEASANT POINT VOTING DISTRICT,162,47,15,19,12,255,,
ME,PLEASANT RIDGE PLT,11,33,4,0,3,51,,
ME,PLYMOUTH,184,484,42,11,27,748,,
ME,POLAND,1244,1685,199,58,98,3284,,
ME,PORTAGE LAKE,88,153,6,3,10,260,,
ME,PORTER,270,462,48,10,32,822,,
ME,PORTLAND,28534,6789,1226,987,1041,38577,,
ME,POWNAL,556,421,60,16,35,1088,,
ME,PRENTISS TWP,18,70,1,2,7,98,,
ME,PRESQUE ISLE,1779,2102,281,78,185,4425,,
ME,PRINCETON,119,330,34,12,15,510,,
ME,PROSPECT,157,224,17,5,15,418,,
ME,RANDOLPH,426,475,59,18,40,1018,,
ME,RANGELEY,287,384,37,11,24,743,,
ME,RANGELEY PLT,51,97,5,3,6,162,,
ME,RAYMOND,1263,1381,93,74,87,2898,,
ME,READFIELD,793,710,84,29,50,1666,,
ME,REED PLT,14,61,0,3,1,79,,
ME,RICHMOND,733,961,115,53,77,1939,,
ME,RIPLEY,72,155,12,21,9,269,,
ME,ROBBINSTON,114,183,13,9,11,330,,
ME,ROCKLAND,2024,1209,147,105,165,3650,,
ME,ROCKPORT,1381,740,107,35,99,2362,,
ME,ROCKWOOD STRIP TWP,57,156,4,1,6,224,,
ME,ROME,282,268,28,16,28,622,,
ME,ROQUE BLUFFS,90,72,4,1,6,173,,
ME,ROXBURY,76,143,17,4,9,249,,
ME,RUMFORD,1137,1400,182,67,138,2924,,
ME,SABATTUS,865,1701,152,50,82,2850,,
ME,SACO,5902,4067,487,189,366,11011,,
ME,SAINT AGATHA,258,279,28,6,15,586,,
ME,SAINT ALBANS,282,768,52,27,34,1163,,
ME,SAINT FRANCIS,127,96,10,3,10,246,,
ME,SAINT GEORGE,930,621,47,29,62,1689,,
ME,SAINT JOHN PLT,58,92,9,3,5,167,,
ME,SANDY RIVER PLT,45,40,1,5,2,93,,
ME,SANFORD,4447,4744,555,231,385,10362,,
ME,SANGERVILLE,209,455,32,16,19,731,,
ME,SCARBOROUGH,6893,4918,533,191,459,12994,,
ME,SEARSMONT,370,390,45,23,25,853,,
ME,SEARSPORT,689,710,78,36,57,1570,,
ME,SEBAGO,421,600,64,20,27,1132,,
ME,SEBEC,102,257,18,6,12,395,,
ME,SEBOEIS PLT,15,19,0,0,1,35,,
ME,SEDGWICK,397,287,33,16,30,763,,
ME,SHAPLEIGH,534,874,89,35,36,1568,,
ME,SHERMAN,141,467,20,6,13,647,,
ME,SHIRLEY,43,93,8,1,5,150,,
ME,SIDNEY,939,1411,160,46,110,2666,,
ME,SKOWHEGAN,1674,2046,211,67,157,4155,,
ME,SMITHFIELD,244,319,29,13,19,624,,
ME,SMYRNA,38,99,4,4,8,153,,
ME,SOLON,233,316,22,16,20,607,,
ME,SOMERVILLE,101,197,29,8,11,346,,
ME,SORRENTO,99,87,11,4,9,210,,
ME,SOUTH BERWICK,2227,1616,223,70,129,4265,,
ME,SOUTH BRISTOL,332,229,40,13,16,630,,
ME,SOUTH PORTLAND,9919,3950,526,291,419,15105,,
ME,SOUTH THOMASTON,445,383,46,13,39,926,,
ME,SOUTHPORT,218,179,18,5,11,431,,
ME,SOUTHWEST HARBOR,646,400,31,15,43,1135,,
ME,SPRINGFIELD,34,130,7,1,6,178,,
ME,STACYVILLE,35,148,3,5,8,199,,
ME,STANDISH,2144,2873,280,80,178,5555,,
ME,STARKS,122,182,15,14,24,357,,
ME,STATE UOCAVA,3017,648,203,101,80,4049,,
ME,STETSON,206,433,52,17,24,732,,
ME,STEUBEN,199,368,38,13,22,640,,
ME,STOCKHOLM,67,53,7,25,5,157,,
ME,STOCKTON SPRINGS,445,471,43,28,34,1021,,
ME,STONEHAM,77,89,5,0,5,176,,
ME,STONINGTON,350,214,19,14,14,611,,
ME,STOW,97,98,15,3,14,227,,
ME,STRONG,225,460,54,13,28,780,,
ME,SULLIVAN,285,300,51,14,27,677,,
ME,SUMNER,187,299,28,13,32,559,,
ME,SURRY,490,418,46,25,37,1016,,
ME,SWANS ISLAND,102,122,13,8,9,254,,
ME,SWANVILLE,286,404,49,24,36,799,,
ME,SWEDEN,115,116,14,3,8,256,,
ME,T10 R15 WELS,0,1,0,0,0,1,,
ME,T10 SD TWP,4,10,0,0,0,14,,
ME,T11 R4 WELS TWP,7,15,0,1,1,24,,
ME,T12/R13 WELS/T9 R8 WELS,2,1,0,0,0,3,,
ME,T15 R6 TWP,0,7,1,0,1,9,,
ME,T17 R3 VAN BUREN COVE TWP,8,12,2,0,2,24,,
ME,T22 MD TWP,0,5,0,0,0,5,,
ME,T26 ED BPP TOWNSHIP,0,3,0,0,0,3,,
ME,T3 ND TWP,3,3,0,0,0,6,,
ME,T4 R3 TWP,1,0,0,0,0,1,,
ME,T5 R7 TWP/T5 R8 TWP/T6 R8 TWPS,4,8,0,0,0,12,,
ME,T7 SD TWP,0,0,2,3,0,5,,
ME,T9 SD/T10 SD TWP,2,5,0,0,0,7,,
ME,TALMADGE,13,22,2,0,3,40,,
ME,TD R2 WELS,4,0,0,0,0,4,,
ME,TEMPLE,154,146,15,6,7,328,,
ME,THE FORKS PLT,9,21,10,0,4,44,,
ME,THOMASTON,785,581,63,38,49,1516,,
ME,THORNDIKE,189,191,24,19,19,442,,
ME,TOPSFIELD,20,95,2,3,1,121,,
ME,TOPSHAM,3109,2328,354,91,223,6105,,
ME,TREMONT,477,381,44,19,22,943,,
ME,TRENTON,398,396,42,15,27,878,,
ME,TROY,216,288,33,16,21,574,,
ME,TURNER,1083,2010,149,46,95,3383,,
ME,UNION,582,665,59,27,36,1369,,
ME,UNITY,448,474,70,44,34,1070,,
ME,UPTON,13,39,3,1,4,60,,
ME,VAN BUREN,501,391,27,11,34,964,,
ME,VANCEBORO,28,57,5,3,2,95,,
ME,VASSALBORO,904,1335,126,34,81,2480,,
ME,VEAZIE,556,483,53,24,52,1168,,
ME,VERONA ISLAND,122,164,19,2,7,314,,
ME,VIENNA,157,195,25,8,11,396,,
ME,VINALHAVEN,448,249,34,32,24,787,,
ME,WADE,41,86,11,4,4,146,,
ME,WAITE,12,34,5,0,0,51,,
ME,WALDO,192,244,18,21,14,489,,
ME,WALDOBORO,1133,1409,123,46,123,2834,,
ME,WALES,219,578,64,6,24,891,,
ME,WALLAGRASS,154,127,9,1,10,301,,
ME,WALTHAM,48,141,15,3,3,210,,
ME,WARREN,765,1181,109,45,53,2153,,
ME,WASHBURN,284,482,45,7,46,864,,
ME,WASHINGTON,323,507,50,36,34,950,,
ME,WASHINGTON TWP,7,9,1,0,0,17,,
ME,WATERBORO,1373,2189,231,82,125,4000,,
ME,WATERFORD,338,493,59,20,37,947,,
ME,WATERVILLE,4171,2424,412,152,274,7433,,
ME,WAYNE,424,321,42,15,13,815,,
ME,WEBSTER PLT,5,26,1,0,0,32,,
ME,WELD,109,148,17,1,13,288,,
ME,WELLINGTON,48,62,5,2,3,120,,
ME,WELLS,3275,2807,334,86,291,6793,,
ME,WESLEY,27,44,3,2,7,83,,
ME,WEST BATH,572,562,51,20,52,1257,,
ME,WEST FORKS PLT,15,31,3,0,0,49,,
ME,WEST GARDINER,792,1186,121,41,69,2209,,
ME,WEST PARIS,340,544,77,21,33,1015,,
ME,WESTBROOK,5431,3573,493,200,323,10020,,
ME,WESTFIELD,85,146,13,1,13,258,,
ME,WESTMANLAND,24,24,0,1,0,49,,
ME,WESTON,55,121,1,3,5,185,,
ME,WESTPORT ISLAND,241,219,29,12,15,516,,
ME,WHITEFIELD,605,687,62,38,39,1431,,
ME,WHITING,139,168,10,4,14,335,,
ME,WHITNEYVILLE,41,56,10,2,6,115,,
ME,WILLIMANTIC,20,58,4,0,6,88,,
ME,WILTON,872,1066,155,30,105,2228,,
ME,WINDHAM,4308,4860,517,169,286,10140,,
ME,WINDSOR,406,813,90,31,48,1388,,
ME,WINN,36,151,4,3,7,201,,
ME,WINSLOW,1825,2100,255,68,158,4406,,
ME,WINTER HARBOR,113,153,25,8,11,310,,
ME,WINTERPORT,866,1109,135,35,85,2230,,
ME,WINTERVILLE PLT,53,73,5,2,5,138,,
ME,WINTHROP,1683,1602,208,86,129,3708,,
ME,WISCASSET,864,1164,105,39,79,2251,,
ME,WOODLAND,231,392,33,6,24,686,,
ME,WOODSTOCK,274,404,54,16,48,796,,
ME,WOODVILLE,23,99,7,1,1,131,,
ME,WOOLWICH,827,1001,111,26,58,2023,,
ME,WYMAN TWP,10,17,0,3,3,33,,
ME,YARMOUTH,3705,1503,236,71,210,5725,,
ME,YORK,4929,3260,374,109,356,9028,,
MI,ALCONA,1732,4201,164,54,47,6198,,
MI,ALGER,1663,2585,177,67,26,4518,,
MI,ALLEGAN,18050,34183,2513,596,444,55786,,
MI,ALPENA,4877,9090,498,160,73,14698,,
MI,ANTRIM,4448,8469,459,146,60,13582,,
MI,ARENAC,2384,4950,270,60,32,7696,,
MI,BARAGA,1156,2158,106,49,21,3490,,
MI,BARRY,9114,19202,1424,346,243,30329,,
MI,BAY,21642,28328,2189,544,274,52977,,
MI,BENZIE,4108,5539,382,149,50,10228,,
MI,BERRIEN,29495,38647,2760,662,467,72031,,
MI,BRANCH,5061,11786,582,151,83,17663,,
MI,CALHOUN,24157,31494,2284,635,332,58902,,
MI,CASS,7270,14243,753,199,130,22595,,
MI,CHARLEVOIX,5137,8674,532,178,68,14589,,
MI,CHEBOYGAN,4302,8683,463,140,84,13672,,
MI,CHIPPEWA,5379,9122,583,243,129,15456,,
MI,CLARE,4249,8505,435,120,80,13389,,
MI,CLINTON,16492,21636,1886,379,262,40655,,
MI,CRAWFORD,2110,4354,267,66,47,6844,,
MI,DELTA,6436,11121,660,182,93,18492,,
MI,DICKINSON,3923,8580,450,123,89,13165,,
MI,EATON,24938,27609,2618,602,454,56221,,
MI,EMMET,6972,10616,806,279,129,18802,,
MI,GD. TRAVERSE,20965,27413,2149,756,306,51589,,
MI,GENESEE,102751,84175,6221,2193,956,196296,,
MI,GLADWIN,3794,8124,393,87,74,12472,,
MI,GOGEBIC,2925,4018,213,118,55,7329,,
MI,GRATIOT,5666,9880,687,140,92,16465,,
MI,HILLSDALE,4799,14095,700,184,162,19940,,
MI,HOUGHTON,6018,8475,837,216,78,15624,,
MI,HURON,4579,10692,477,104,65,15917,,
MI,INGHAM,79110,43868,5305,1846,1009,131138,,
MI,IONIA,8352,16635,1355,286,226,26854,,
MI,IOSCO,4345,8345,459,146,66,13361,,
MI,IRON,2004,3675,175,36,20,5910,,
MI,ISABELLA,11404,12338,1093,396,161,25392,,
MI,JACKSON,25795,39793,2901,713,475,69677,,
MI,KALAMAZOO,67148,51034,5644,1634,839,126299,,
MI,KALKASKA,2280,6116,283,118,36,8833,,
MI,KENT,138683,148180,14246,3996,3079,308184,,
MI,KEWEENAW,527,814,62,20,11,1434,,
MI,LAKE,1939,3159,152,48,30,5328,,
MI,LAPEER,12734,30037,1730,426,256,45183,,
MI,LEELANAU,6774,7239,510,197,37,14757,,
MI,LENAWEE,16750,26430,2044,449,266,45939,,
MI,LIVINGSTON,34384,65680,4266,911,625,105866,,
MI,LUCE,681,1756,103,29,10,2579,,
MI,MACKINAC,2085,3744,180,67,21,6097,,
MI,MACOMB,176317,224665,12862,3886,1582,419312,,
MI,MANISTEE,4979,6915,456,200,49,12599,,
MI,MARQUETTE,16042,14646,1458,583,247,32976,,
MI,MASON,5281,8505,601,189,109,14685,,
MI,MECOSTA,5827,10305,697,229,110,17168,,
MI,MENOMINEE,3539,6702,351,118,58,10768,,
MI,MIDLAND,15635,23846,2216,407,402,42506,,
MI,MISSAUKEE,1565,5386,241,74,51,7317,,
MI,MONROE,26863,43261,2985,707,402,74218,,
MI,MONTCALM,7874,16907,1316,292,220,26609,,
MI,MONTMORENCY,1287,3498,159,44,21,5009,,
MI,MUSKEGON,37304,36127,3182,964,511,78088,,
MI,NEWAYGO,6212,15173,878,197,180,22640,,
MI,OAKLAND,343070,289203,23154,6396,2791,664614,,
MI,OCEANA,3973,7228,492,116,121,11930,,
MI,OGEMAW,3030,6827,353,118,59,10387,,
MI,ONTONAGON,1176,2066,128,29,27,3426,,
MI,OSCEOLA,2705,7336,401,96,71,10609,,
MI,OSCODA,1044,2843,140,18,28,4073,,
MI,OTSEGO,3556,8266,482,163,71,12538,,
MI,OTTAWA,44973,88467,6324,1418,1552,142734,,
MI,PRESQUE ISLE,2400,4488,237,50,43,7218,,
MI,ROSCOMMON,4287,8141,413,142,58,13041,,
MI,SAGINAW,44396,45469,3199,780,476,94320,,
MI,SANILAC,4873,13446,662,170,98,19249,,
MI,SCHOOLCRAFT,1369,2556,165,31,33,4154,,
MI,SHIAWASSEE,12546,19230,1660,362,313,34111,,
MI,ST. CLAIR,24553,49051,2972,1062,365,78003,,
MI,ST. JOSEPH,7526,14884,934,290,123,23757,,
MI,TUSCOLA,7429,17102,872,221,172,25796,,
MI,VAN BUREN,13258,17890,1480,417,229,33274,,
MI,WASHTENAW,128483,50631,5840,2472,1152,188578,,
MI,WAYNE,519444,228993,18801,7784,2816,777838,,
MI,WEXFORD,4436,10000,579,192,91,15298,,
MN,AITKIN,3134,5516,263,67,251,9231,,
MN,ANOKA,75500,93339,7726,2123,7070,185758,,
MN,BECKER,5208,10880,580,130,424,17222,,
MN,BELTRAMI,8688,10783,780,420,893,21564,,
MN,BENTON,5640,12872,683,245,618,20058,,
MN,BIG STONE,921,1608,94,20,112,2755,,
MN,BLUE EARTH,14428,15667,1604,587,1307,33593,,
MN,BROWN,3763,8708,503,136,669,13779,,
MN,CARLTON,8460,8160,703,233,655,18211,,
MN,CARVER,21508,29056,2461,488,2183,55696,,
MN,CASS,4949,9982,414,212,442,15999,,
MN,CHIPPEWA,1978,3764,209,70,201,6222,,
MN,CHISAGO,9278,18441,1213,317,979,30228,,
MN,CLAY,12971,13543,1486,416,982,29398,,
MN,CLEARWATER,1100,2925,94,33,93,4245,,
MN,COOK,1912,1156,105,77,145,3395,,
MN,COTTONWOOD,1678,3679,150,41,173,5721,,
MN,CROW WING,10982,22287,1174,311,1088,35842,,
MN,DAKOTA,110483,99583,9879,2678,8817,231440,,
MN,DODGE,3102,6527,454,98,473,10654,,
MN,DOUGLAS,6227,13966,781,167,644,21785,,
MN,FARIBAULT,2153,4659,271,63,266,7412,,
MN,FILLMORE,3872,6271,409,103,400,11055,,
MN,FREEBORN,6041,8808,511,169,522,16051,,
MN,GOODHUE,9446,14041,1130,262,838,25717,,
MN,GRANT,1105,2063,159,27,119,3473,,
MN,HENNEPIN,429288,191770,24400,10310,24209,679977,,
MN,HOUSTON,4145,5616,394,135,314,10604,,
MN,HUBBARD,3423,7261,342,132,347,11505,,
MN,ISANTI,5657,13635,765,219,740,21016,,
MN,ITASCA,9015,12920,792,274,879,23880,,
MN,JACKSON,1492,3609,181,49,153,5484,,
MN,KANABEC,2327,5230,298,81,241,8177,,
MN,KANDIYOHI,7266,12785,927,164,630,21772,,
MN,KITTSON,823,1349,121,15,77,2385,,
MN,KOOCHICHING,2306,3569,207,69,212,6363,,
MN,LAC QUI PARLE,1305,2293,106,33,123,3860,,
MN,LAKE,3077,2932,215,93,204,6521,,
MN,LAKE OF THE WOODS,553,1540,67,16,66,2242,,
MN,LE SUEUR,4623,9182,514,146,506,14971,,
MN,LINCOLN,860,1931,112,18,98,3019,,
MN,LYON,3825,7256,523,115,496,12215,,
MN,MAHNOMEN,930,991,54,34,79,2088,,
MN,MARSHALL,1225,3208,204,30,150,4817,,
MN,MARTIN,2733,7062,343,79,314,10531,,
MN,MCLEOD,4978,12155,857,135,682,18807,,
MN,MEEKER,3191,8104,448,94,445,12282,,
MN,MILLE LACS,3710,8340,451,128,388,13017,,
MN,MORRISON,3637,12925,442,146,464,17614,,
MN,MOWER,7437,8823,620,191,644,17715,,
MN,MURRAY,1295,2974,203,22,174,4668,,
MN,NICOLLET,7886,8437,831,250,693,18097,,
MN,NOBLES,2733,5299,258,40,302,8632,,
MN,NORMAN,1264,1699,161,29,108,3261,,
MN,OLMSTED,36268,35668,3547,1117,3529,80129,,
MN,OTTER TAIL,9340,20939,1000,245,976,32500,,
MN,PENNINGTON,2147,4000,315,46,207,6715,,
MN,PINE,4580,8191,473,147,420,13811,,
MN,PIPESTONE,1127,3338,131,44,168,4808,,
MN,POLK,4712,8979,517,124,464,14796,,
MN,POPE,2106,3793,221,43,156,6319,,
MN,RAMSEY,177738,70894,9626,4560,10325,273143,,
MN,RED LAKE,540,1141,100,23,77,1881,,
MN,REDWOOD,1887,5137,242,77,268,7611,,
MN,RENVILLE,2117,4890,244,66,289,7606,,
MN,RICE,14437,15429,1230,386,961,32443,,
MN,ROCK,1373,3091,155,40,180,4839,,
MN,ROSEAU,1856,5451,220,42,235,7804,,
MN,SCOTT,28502,39948,3400,740,2439,75029,,
MN,SHERBURNE,13293,31053,1927,457,1553,48283,,
MN,SIBLEY,1954,5193,291,64,272,7774,,
MN,ST. LOUIS,57771,44630,4366,1878,3777,112422,,
MN,STEARNS,25576,47617,2972,954,2473,79592,,
MN,STEELE,6241,11198,808,208,724,19179,,
MN,STEVENS,2116,2799,205,69,209,5398,,
MN,SWIFT,1686,2963,153,33,159,4994,,
MN,TODD,2783,8485,287,96,342,11993,,
MN,TRAVERSE,630,1049,40,16,63,1798,,
MN,WABASHA,3866,6989,467,127,383,11832,,
MN,WADENA,1684,4837,164,58,191,6934,,
MN,WASECA,2838,5967,387,106,355,9653,,
MN,WASHINGTON,67086,64428,6180,1478,5063,144235,,
MN,WATONWAN,1814,2768,156,52,208,4998,,
MN,WILKIN,893,2129,146,34,100,3302,,
MN,WINONA,11366,12122,1165,531,890,26074,,
MN,WRIGHT,20334,43274,3002,547,2461,69618,,
MN,YELLOW MEDICINE,1524,3382,163,37,170,5276,,
MO,Adair,3500,6030,426,147,123,10226,,
MO,Andrew,2045,6665,336,64,30,9140,,
MO,Atchison,541,2060,104,14,11,2730,,
MO,Audrain,2570,6981,363,73,74,10061,,
MO,Barry,2710,11428,338,66,63,14605,,
MO,Barton,795,4959,135,22,28,5939,,
MO,Bates,1618,6001,306,55,51,8031,,
MO,Benton,2025,7213,278,41,33,9590,,
MO,Bollinger,705,4827,97,12,35,5676,,
MO,Boone,41125,36200,4268,1280,995,83868,,
MO,Buchanan,12013,21320,1709,343,274,35659,,
MO,Butler,3036,13650,392,98,83,17259,,
MO,Caldwell,838,3232,188,26,28,4312,,
MO,Callaway,4989,13057,757,182,208,19193,,
MO,Camden,4768,16944,597,110,95,22514,,
MO,Cape Girardeau,8492,27017,1109,239,181,37038,,
MO,Carroll,745,3480,106,17,13,4361,,
MO,Carter,436,2324,55,18,17,2850,,
MO,Cass,14846,33098,2159,420,467,50990,,
MO,Cedar,1011,5021,179,30,47,6288,,
MO,Chariton,888,2950,98,10,23,3969,,
MO,Christian,8508,30946,1495,245,337,41531,,
MO,Clark,724,2458,101,22,11,3316,,
MO,Clay,45304,57476,5155,1097,1144,110176,,
MO,Clinton,2572,7067,434,77,58,10208,,
MO,Cole,10913,24616,1377,254,214,37374,,
MO,Cooper,1932,5624,306,58,66,7986,,
MO,Crawford,1824,7724,224,91,57,9920,,
MO,Dade,637,3184,94,16,20,3951,,
MO,Dallas,1272,5895,181,49,56,7453,,
MO,Daviess,730,2767,145,18,78,3738,,
MO,De Kalb,824,3540,178,30,22,4594,,
MO,Dent,978,5600,136,36,41,6791,,
MO,Douglas,984,5486,135,21,40,6666,,
MO,Dunklin,2360,8026,142,30,20,10578,,
MO,Franklin,12341,35430,1628,428,286,50113,,
MO,Gasconade,1520,5670,180,47,34,7451,,
MO,Gentry,605,2304,108,9,17,3043,,
MO,Greene,42728,78035,5754,1465,1249,129231,,
MO,Grundy,780,3462,118,28,40,4428,,
MO,Harrison,574,2965,97,19,34,3689,,
MO,Henry,2357,7075,311,61,62,9866,,
MO,Hickory,1016,3542,108,31,27,4724,,
MO,Holt,347,1926,66,6,10,2355,,
MO,Howard,1283,3277,209,41,58,4868,,
MO,Howell,2881,13893,434,132,115,17455,,
MO,Iron,933,3173,110,30,23,4269,,
MO,Jackson,71237,91557,7128,1799,1554,173275,,
MO,Jasper,10572,35070,1761,484,439,48326,,
MO,Jefferson,31568,69036,3968,930,736,106238,,
MO,Johnson,5930,13719,1100,205,178,21132,,
MO,Kansas City,97735,24654,3715,1726,771,128601,,
MO,Knox,379,1416,53,12,10,1870,,
MO,Laclede,2553,12881,426,87,104,16051,,
MO,Lafayette,4053,10988,598,92,145,15876,,
MO,Lawrence,2901,13089,472,104,149,16715,,
MO,Lewis,934,3344,127,26,25,4456,,
MO,Lincoln,5575,18159,808,198,222,24962,,
MO,Linn,1240,4088,172,54,33,5587,,
MO,Livingston,1265,4879,213,20,44,6421,,
MO,Macon,1548,5798,175,57,53,7631,,
MO,Madison,1005,4102,150,30,34,5321,,
MO,Maries,794,3561,110,23,12,4500,,
MO,Marion,2994,9419,380,63,82,12938,,
MO,McDonald,1329,6599,191,70,53,8242,,
MO,Mercer,216,1486,27,2,14,1745,,
MO,Miller,1750,9285,283,58,40,11416,,
MO,Mississippi,1458,3600,79,15,17,5169,,
MO,Moniteau,1237,5347,177,26,43,6830,,
MO,Monroe,853,3159,114,13,17,4156,,
MO,Montgomery,1119,4127,134,32,17,5429,,
MO,Morgan,1768,6760,202,51,40,8821,,
MO,New Madrid,1933,5270,106,24,24,7357,,
MO,Newton,4990,20553,641,168,254,26606,,
MO,Nodaway,2529,6380,401,61,87,9458,,
MO,Oregon,865,3671,88,14,30,4668,,
MO,Osage,998,5856,182,34,20,7090,,
MO,Ozark,724,3639,70,41,31,4505,,
MO,Pemiscot,1947,3964,79,21,16,6027,,
MO,Perry,1520,6908,231,39,42,8740,,
MO,Pettis,4324,12810,735,112,130,18111,,
MO,Phelps,4766,12709,750,198,130,18553,,
MO,Pike,1806,5274,208,50,44,7382,,
MO,Platte,20057,25933,2271,426,413,49100,,
MO,Polk,2631,10438,479,77,138,13763,,
MO,Pulaski,2922,9876,485,106,99,13488,,
MO,Putnam,353,1936,36,13,8,2346,,
MO,Ralls,1138,3969,120,17,22,5266,,
MO,Randolph,2283,7529,392,60,45,10309,,
MO,Ray,3090,7104,509,61,105,10869,,
MO,Reynolds,540,2406,62,21,9,3038,,
MO,Ripley,830,4522,115,35,22,5524,,
MO,Saline,2789,5977,383,69,56,9274,,
MO,Schuyler,354,1505,64,7,6,1936,,
MO,Scotland,365,1525,50,18,10,1968,,
MO,Scott,3575,13168,374,79,60,17256,,
MO,Shannon,776,2966,106,28,28,3904,,
MO,Shelby,606,2524,92,16,17,3255,,
MO,St. Charles,68626,121650,7964,1698,1067,201005,,
MO,St. Clair,936,3501,146,24,23,4630,,
MO,St. Francois,6250,17468,712,171,127,24728,,
MO,St. Louis,286704,202434,16677,5207,3836,514858,,
MO,St. Louis City,104235,20832,3518,2005,601,131191,,
MO,Ste. Genevieve,2542,5496,324,56,51,8469,,
MO,Stoddard,1876,11079,238,45,53,13291,,
MO,Stone,2887,13158,383,59,80,16567,,
MO,Sullivan,526,1884,58,9,9,2486,,
MO,Taney,4373,18276,525,129,212,23515,,
MO,Texas,1728,8875,222,52,79,10956,,
MO,Vernon,1707,6533,236,67,56,8599,,
MO,Warren,3915,11111,534,116,108,15784,,
MO,Washington,1926,7048,197,60,51,9282,,
MO,Wayne,948,4658,107,29,20,5762,,
MO,Webster,3177,12840,515,85,126,16743,,
MO,Worth,195,808,32,5,6,1046,,
MO,Wright,1170,6707,153,22,67,8119,,
MS,state,485131,700714,14435,3731,5346,1209357,,
MT,Beaverhead,1143,3353,265,70,18,4849,,
MT,Big Horn,2094,1853,185,71,21,4224,,
MT,Blaine,1202,1268,102,73,26,2671,,
MT,Broadwater,573,2348,169,37,5,3132,,
MT,Carbon,1828,3748,307,70,14,5967,,
MT,Carter,70,678,24,6,1,779,,
MT,Cascade,12175,19632,1996,446,135,34384,,
MT,Chouteau,732,1679,131,37,10,2589,,
MT,Custer,1176,3657,302,35,15,5185,,
MT,Daniels,168,730,51,6,0,955,,
MT,Dawson,787,3320,184,33,7,4331,,
MT,Deer Lodge,2058,1763,276,74,23,4194,,
MT,Fallon,154,1279,45,4,2,1484,,
MT,Fergus,1202,4269,302,52,15,5840,,
MT,Flathead,13293,30240,2199,656,106,46494,,
MT,Gallatin,24246,23802,4015,1061,168,53292,,
MT,Garfield,34,653,27,1,1,716,,
MT,Glacier,3121,1620,203,95,22,5061,,
MT,Golden Valley,71,365,29,3,3,471,,
MT,Granite,472,1192,83,25,3,1775,,
MT,Hill,2371,3478,438,118,21,6426,,
MT,Jefferson,1998,4177,394,75,24,6668,,
MT,Judith Basin,235,872,79,12,3,1201,,
MT,Lake,4776,7530,534,229,41,13110,,
MT,Lewis & Clark,14478,16895,2210,559,103,34245,,
MT,Liberty,206,698,47,2,3,956,,
MT,Lincoln,2041,6729,396,96,22,9284,,
MT,Madison,1180,3297,195,58,13,4743,,
MT,McCone,154,862,37,7,0,1060,,
MT,Meagher,193,729,41,10,2,975,,
MT,Mineral,519,1330,108,35,11,2003,,
MT,Missoula,31543,22250,3357,1704,172,59026,,
MT,Musselshell,332,1967,94,18,5,2416,,
MT,Park,3595,4980,500,200,31,9306,,
MT,Petroleum,30,278,12,1,1,322,,
MT,Phillips,318,1723,99,19,2,2161,,
MT,Pondera,738,1799,135,34,10,2716,,
MT,Powder River,127,884,39,1,0,1051,,
MT,Powell,551,2029,163,41,10,2794,,
MT,Prairie,100,556,30,1,2,689,,
MT,Ravalli,6223,14810,992,261,60,22346,,
MT,Richland,671,3908,239,23,6,4847,,
MT,Roosevelt,1560,1797,180,95,16,3648,,
MT,Rosebud,987,2253,152,33,15,3440,,
MT,Sanders,1218,4286,299,94,13,5910,,
MT,Sheridan,477,1241,92,20,2,1832,,
MT,Silver Bow,8619,6376,1057,293,94,16439,,
MT,Stillwater,908,3661,251,35,11,4866,,
MT,Sweet Grass,402,1595,77,23,3,2100,,
MT,Teton,808,2170,162,27,12,3179,,
MT,Toole,402,1497,96,29,6,2030,,
MT,Treasure,59,351,26,6,1,443,,
MT,Valley,886,2698,234,44,14,3876,,
MT,Wheatland,179,702,43,14,6,944,,
MT,Wibaux,55,463,18,0,1,537,,
MT,Yellowstone,22171,40920,4316,898,239,68544,,
NC,ALAMANCE,29818,38802,1795,216,496,71127,,
NC,ALEXANDER,3767,13892,437,23,151,18270,,
NC,ALLEGHANY,1306,3814,129,0,66,5315,,
NC,ANSON,5859,4506,129,3,48,10545,,
NC,ASHE,3500,9413,332,0,180,13425,,
NC,AVERY,1689,6298,166,23,73,8249,,
NC,BEAUFORT,8764,14543,426,25,180,23938,,
NC,BERTIE,5778,3456,70,3,40,9347,,
NC,BLADEN,7021,8511,211,0,76,15819,,
NC,BRUNSWICK,23282,42717,1717,96,536,68348,,
NC,BUNCOMBE,75421,55694,4284,1534,1958,138891,,
NC,BURKE,11251,26238,988,119,324,38920,,
NC,CABARRUS,35510,53789,2784,190,972,93245,,
NC,CALDWELL,8425,26621,849,123,302,36320,,
NC,CAMDEN,1274,3546,149,8,29,5006,,
NC,CARTERET,9939,26569,913,82,278,37781,,
NC,CASWELL,4792,6027,214,9,29,11071,,
NC,CATAWBA,21216,48324,1973,153,685,72351,,
NC,CHATHAM,21065,17105,1130,137,412,39849,,
NC,CHEROKEE,2860,10844,346,33,98,14181,,
NC,CHOWAN,2992,4014,162,11,49,7228,,
NC,CLAY,1367,4437,143,9,54,6010,,
NC,CLEVELAND,14964,28479,850,75,305,44673,,
NC,COLUMBUS,9053,14264,305,0,91,23713,,
NC,CRAVEN,17629,27722,1210,50,380,46991,,
NC,CUMBERLAND,71605,51265,3373,179,1084,127506,,
NC,CURRITUCK,2913,9163,482,27,84,12669,,
NC,DARE,7323,11626,690,52,205,19896,,
NC,DAVIDSON,18102,54304,1858,87,484,74835,,
NC,DAVIE,5270,15602,631,47,206,21756,,
NC,DUPLIN,8283,12217,260,11,85,20856,,
NC,DURHAM,121166,28314,3995,535,1996,156006,,
NC,EDGECOMBE,16224,8261,284,11,106,24886,,
NC,FORSYTH,94442,75947,5367,0,2499,178255,,
NC,FRANKLIN,12874,16368,777,53,296,30368,,
NC,GASTON,31177,61798,2445,138,873,96431,,
NC,GATES,2385,2874,108,0,25,5392,,
NC,GRAHAM,768,3281,74,0,43,4166,,
NC,GRANVILLE,12909,13591,596,42,215,27353,,
NC,GREENE,3605,4374,85,4,27,8095,,
NC,GUILFORD,149248,98062,6754,674,2667,257405,,
NC,HALIFAX,15748,9031,290,0,98,25167,,
NC,HARNETT,16737,27614,1252,73,389,46065,,
NC,HAYWOOD,10473,18929,905,117,303,30727,,
NC,HENDERSON,19827,35807,1626,227,687,58174,,
NC,HERTFORD,6910,3099,133,0,44,10186,,
NC,HOKE,9725,7759,577,27,140,18228,,
NC,HYDE,965,1288,42,1,8,2304,,
NC,IREDELL,24734,54754,2185,140,754,82567,,
NC,JACKSON,7713,9870,742,112,276,18713,,
NC,JOHNSTON,28362,54372,2347,112,716,85909,,
NC,JONES,2065,2974,59,0,37,5135,,
NC,LEE,10469,13712,684,28,191,25084,,
NC,LENOIR,12726,13667,401,19,146,26959,,
NC,LINCOLN,9897,28806,971,44,305,40023,,
NC,MACON,4876,12127,467,36,228,17734,,
NC,MADISON,3926,6783,336,121,103,11269,,
NC,MARTIN,5846,5897,165,9,47,11964,,
NC,MCDOWELL,4667,14568,396,15,229,19875,,
NC,MECKLENBURG,294562,155518,15488,1352,5937,472857,,
NC,MITCHELL,1596,6282,138,24,56,8096,,
NC,MONTGOMERY,4150,7130,203,6,51,11540,,
NC,MOORE,16328,30487,1354,54,464,48687,,
NC,NASH,23235,23318,750,60,301,47664,,
NC,NEW HANOVER,50975,55340,3949,449,1184,111897,,
NC,NORTHAMPTON,6144,3582,93,0,29,9848,,
NC,ONSLOW,17514,37122,1926,92,481,57135,,
NC,ORANGE,59923,18557,2404,459,997,82340,,
NC,PAMLICO,2448,4258,124,10,30,6870,,
NC,PASQUOTANK,8615,8180,442,32,122,17391,,
NC,PENDER,9354,17639,683,52,157,27885,,
NC,PERQUIMANS,2319,4177,162,7,43,6708,,
NC,PERSON,7833,11185,419,36,142,19615,,
NC,PITT,41824,35691,2162,170,680,80527,,
NC,POLK,3735,6768,272,52,107,10934,,
NC,RANDOLPH,13194,49430,1403,102,446,64575,,
NC,RICHMOND,8501,10383,333,24,87,19328,,
NC,ROBESON,19016,20762,803,25,252,40858,,
NC,ROCKINGHAM,14228,26830,871,55,294,42278,,
NC,ROWAN,19400,42810,1517,78,564,64369,,
NC,RUTHERFORD,7515,21869,624,39,261,30308,,
NC,SAMPSON,10547,14838,393,0,150,25928,,
NC,SCOTLAND,7319,6256,254,26,73,13928,,
NC,STANLY,7094,21964,664,26,169,29917,,
NC,STOKES,4665,17116,571,25,173,22550,,
NC,SURRY,7488,23671,739,48,250,32196,,
NC,SWAIN,2196,3566,240,29,92,6123,,
NC,TRANSYLVANIA,6558,10520,489,82,220,17869,,
NC,TYRRELL,720,975,28,5,11,1739,,
NC,UNION,34335,66705,3327,163,1176,105706,,
NC,VANCE,12229,7332,294,25,97,19977,,
NC,WAKE,302727,196080,19460,1740,7605,527612,,
NC,WARREN,6419,3215,147,0,69,9850,,
NC,WASHINGTON,3509,2564,65,1,25,6164,,
NC,WATAUGA,14138,13697,1336,275,539,29985,,
NC,WAYNE,21769,27540,963,33,383,50688,,
NC,WILKES,6638,23752,647,31,228,31296,,
NC,WILSON,19663,17531,667,18,256,38135,,
NC,YADKIN,3160,13880,398,34,152,17624,,
NC,YANCEY,3196,6385,261,41,77,9960,,
ND,Adams,216,909,65,8,20,1218,,
ND,Barnes,1597,3160,407,47,133,5344,,
ND,Benson,842,929,112,41,87,2011,,
ND,Billings,59,495,33,4,14,605,,
ND,Bottineau,736,2494,177,30,57,3494,,
ND,Bowman,227,1446,79,13,22,1787,,
ND,Burke,119,895,26,5,7,1052,,
ND,Burleigh,10881,32532,2722,480,1364,47979,,
ND,Cass,31361,39816,6085,1209,2350,80821,,
ND,Cavalier,476,1357,110,19,44,2006,,
ND,Dickey,554,1667,123,23,40,2407,,
ND,Divide,245,867,71,9,27,1219,,
ND,Dunn,358,1771,60,14,40,2243,,
ND,Eddy,355,791,53,15,17,1231,,
ND,Emmons,215,1677,52,10,27,1981,,
ND,Foster,347,1241,96,10,25,1719,,
ND,Golden Valley,99,796,40,4,18,957,,
ND,Grand Forks,10851,16340,2004,383,787,30365,,
ND,Grant,185,1108,65,7,16,1381,,
ND,Griggs,298,847,93,6,21,1265,,
ND,Hettinger,168,1050,46,5,27,1296,,
ND,Kidder,179,1111,64,7,15,1376,,
ND,LaMoure,502,1481,109,13,46,2151,,
ND,Logan,114,888,38,5,22,1067,,
ND,McHenry,490,2050,189,20,71,2820,,
ND,McIntosh,235,1100,71,10,30,1446,,
ND,McKenzie,698,3670,172,35,97,4672,,
ND,McLean,1081,3860,256,29,89,5315,,
ND,Mercer,621,3759,190,21,91,4682,,
ND,Morton,3080,11336,914,141,361,15832,,
ND,Mountrail,1220,2582,166,56,82,4106,,
ND,Nelson,536,1025,114,11,31,1717,,
ND,Oliver,119,830,47,3,18,1017,,
ND,Pembina,681,2208,167,28,69,3153,,
ND,Pierce,431,1437,132,9,62,2071,,
ND,Ramsey,1505,3217,405,44,134,5305,,
ND,Ransom,838,1210,247,22,42,2359,,
ND,Renville,201,993,71,4,24,1293,,
ND,Richland,2064,4767,493,76,192,7592,,
ND,Rolette,2099,1217,156,175,108,3755,,
ND,Sargent,694,1088,167,18,30,1997,,
ND,Sheridan,95,650,29,1,12,787,,
ND,Sioux,758,260,25,128,61,1232,,
ND,Slope,43,362,19,3,3,430,,
ND,Stark,1753,9755,526,60,228,12322,,
ND,Steele,361,538,75,6,19,999,,
ND,Stutsman,2498,6718,574,109,256,10155,,
ND,Towner,305,733,90,7,22,1157,,
ND,Traill,1241,2265,292,35,100,3933,,
ND,Walsh,1167,2995,330,32,112,4636,,
ND,Ward,5806,18636,2055,242,673,27412,,
ND,Wells,419,1796,101,14,53,2383,,
ND,Williams,1735,10069,631,74,298,12807,,
NE,Adams,3302,9287,594,111,219,13513,,
NE,Antelope,383,2732,105,19,42,3281,,
NE,Arthur,17,244,11,0,1,273,,
NE,Banner,19,357,14,3,9,402,,
NE,Blaine,30,276,10,0,1,317,,
NE,Boone,414,2299,137,17,38,2905,,
NE,Box Butte,965,3617,230,36,76,4924,,
NE,Boyd,128,983,23,13,9,1156,,
NE,Brown,153,1385,39,7,13,1597,,
NE,Buffalo,4763,14569,1174,227,396,21129,,
NE,Burt,930,2367,197,39,25,3558,,
NE,Butler,691,3079,129,27,55,3981,,
NE,Cass,3484,8452,639,132,226,12933,,
NE,Cedar,571,3532,224,31,62,4420,,
NE,Chase,171,1648,54,6,19,1898,,
NE,Cherry,317,2623,127,15,36,3118,,
NE,Cheyenne,711,3665,213,46,76,4711,,
NE,Clay,477,2422,116,15,35,3065,,
NE,Colfax,859,2171,118,26,40,3214,,
NE,Cuming,719,3122,157,26,50,4074,,
NE,Custer,641,4695,206,37,73,5652,,
NE,Dakota,2314,3616,229,50,70,6279,,
NE,Dawes,801,2632,191,52,0,3676,,
NE,Dawson,2136,5984,381,58,76,8635,,
NE,Deuel,120,809,47,1,7,984,,
NE,Dixon,556,2041,130,17,38,2782,,
NE,Dodge,4544,9933,624,162,266,15529,,
NE,Douglas,113798,108077,10402,2882,5274,240433,,
NE,Dundy,89,823,31,6,4,953,,
NE,Fillmore,613,2130,151,21,26,2941,,
NE,Franklin,250,1347,54,7,15,1673,,
NE,Frontier,161,1110,36,8,13,1328,,
NE,Furnas,304,1921,85,11,19,2340,,
NE,Gage,2935,6380,492,104,137,10048,,
NE,Garden,153,869,39,2,12,1075,,
NE,Garfield,121,821,23,5,10,980,,
NE,Gosper,166,794,38,6,6,1010,,
NE,Grant,20,367,6,1,11,405,,
NE,Greeley,210,912,38,6,9,1175,,
NE,Hall,6282,14408,895,192,283,22060,,
NE,Hamilton,878,3783,224,43,76,5004,,
NE,Harlan,254,1496,62,7,13,1832,,
NE,Hayes,30,472,8,1,3,514,,
NE,Hitchcock,161,1232,61,7,7,1468,,
NE,Holt,531,4354,162,27,44,5118,,
NE,Hooker,40,355,16,3,3,417,,
NE,Howard,544,2284,108,22,36,2994,,
NE,Jefferson,837,2399,182,30,46,3494,,
NE,Johnson,563,1355,122,22,27,2089,,
NE,Kearney,550,2531,148,26,41,3296,,
NE,Keith,571,3235,164,25,39,4034,,
NE,Keya Paha,40,460,17,0,2,519,,
NE,Kimball,230,1330,78,18,21,1677,,
NE,Knox,720,3188,137,29,41,4115,,
NE,Lancaster,61898,61588,7109,1974,3654,136223,,
NE,Lincoln,2913,12164,711,107,236,16131,,
NE,Logan,32,400,18,1,2,453,,
NE,Loup,48,323,10,1,3,385,,
NE,Madison,2711,10628,669,126,209,14343,,
NE,McPherson,14,257,14,1,1,287,,
NE,Merrick,602,2926,165,29,66,3788,,
NE,Morrill,284,1802,84,14,25,2209,,
NE,Nance,281,1261,48,14,17,1621,,
NE,Nemaha,785,2116,180,27,53,3161,,
NE,Nuckolls,353,1726,88,20,18,2205,,
NE,Otoe,2025,4860,375,58,139,7457,,
NE,Pawnee,279,974,55,10,9,1327,,
NE,Perkins,161,1217,54,5,18,1455,,
NE,Phelps,572,3849,190,18,66,4695,,
NE,Pierce,382,3052,125,21,50,3630,,
NE,Platte,2646,10965,495,86,241,14433,,
NE,Polk,413,2028,102,6,33,2582,,
NE,Red Willow,645,4258,191,26,50,5170,,
NE,Richardson,818,2769,159,27,32,3805,,
NE,Rock,70,687,33,4,4,798,,
NE,Saline,1733,3004,284,52,63,5136,,
NE,Sarpy,28033,45143,4682,836,1886,80580,,
NE,Saunders,2523,7555,515,97,170,10860,,
NE,Scotts Bluff,3207,10076,683,126,225,14317,,
NE,Seward,1875,5454,337,84,172,7922,,
NE,Sheridan,287,2211,70,18,22,2608,,
NE,Sherman,340,1150,59,13,11,1573,,
NE,Sioux,81,616,28,4,7,736,,
NE,Stanton,417,2187,144,14,39,2801,,
NE,Thayer,499,2051,124,10,6,2690,,
NE,Thomas,30,344,10,3,6,393,,
NE,Thurston,919,1043,56,49,21,2088,,
NE,Valley,339,1780,53,12,21,2205,,
NE,Washington,2623,7424,513,97,175,10832,,
NE,Wayne,835,2693,202,35,11,3776,,
NE,Webster,306,1330,51,10,11,1708,,
NE,Wheeler,62,377,17,4,5,465,,
NE,York,1186,4700,345,52,98,6381,,
NH,Acworth,274,240,10,17,11,552,,
NH,Albany,195,182,13,7,2,399,,
NH,Alexandria,343,546,42,10,0,941,,
NH,Allenstown,874,1203,97,17,0,2191,,
NH,Alstead,522,444,37,20,1,1024,,
NH,Alton,1152,2201,115,24,2,3494,,
NH,Amherst,3777,3271,252,47,4,7351,,
NH,Andover,703,673,49,7,2,1434,,
NH,Antrim,668,748,71,13,12,1512,,
NH,Ashland,504,520,47,11,1,1083,,
NH,Atkinson,1671,2595,159,31,4,4460,,
NH,Auburn,1307,2031,145,22,3,3508,,
NH,Barnstead,924,1520,125,20,0,2589,,
NH,Barrington,2375,2469,309,65,4,5222,,
NH,Bartlett,1094,730,84,21,0,1929,,
NH,Bath,211,292,27,5,0,535,,
NH,Bedford,5851,6816,536,58,6,13267,,
NH,Belmont,1272,2192,158,28,7,3657,,
NH,Bennington,327,422,41,8,2,800,,
NH,Benton,72,105,6,5,0,188,,
NH,Berlin,1954,1766,156,34,7,3917,,
NH,Bethlehem,796,573,48,24,0,1441,,
NH,Boscawen,833,929,83,16,0,1861,,
NH,Bow,2570,2119,218,28,2,4937,,
NH,Bradford,442,485,41,15,0,983,,
NH,Brentwood,1145,1267,121,19,3,2555,,
NH,Bridgewater,267,423,24,4,0,718,,
NH,Bristol,626,900,74,21,4,1625,,
NH,Brookfield,156,262,25,3,1,447,,
NH,Brookline,1417,1501,170,32,3,3123,,
NH,Cambridge,1,1,0,0,0,2,,
NH,Campton,890,870,88,20,3,1871,,
NH,Canaan,938,850,65,26,2,1881,,
NH,Candia,855,1553,131,15,0,2554,,
NH,Canterbury,815,671,58,20,1,1565,,
NH,Carroll,213,245,9,6,0,473,,
NH,Center Harbor,324,357,23,8,1,713,,
NH,Charlestown,1041,1159,92,20,5,2317,,
NH,Chatham,79,103,19,3,0,204,,
NH,Chester,1092,1727,125,13,1,2958,,
NH,Chesterfield,1166,910,71,11,3,2161,,
NH,Chichester,646,851,75,7,0,1579,,
NH,Claremont Ward 1,716,715,81,23,2,1537,,
NH,Claremont Ward 2,974,1039,91,28,0,2132,,
NH,Claremont Ward 3,839,926,64,14,0,1843,,
NH,Clarksville,68,95,5,4,0,172,,
NH,Colebrook,359,593,51,13,3,1019,,
NH,Columbia,109,219,13,2,0,343,,
NH,Concord Ward 1,1266,939,114,37,4,2360,,
NH,Concord Ward 10,1571,1120,110,17,2,2820,,
NH,Concord Ward 2,1084,897,90,24,2,2097,,
NH,Concord Ward 3,923,538,73,14,5,1553,,
NH,Concord Ward 4,1334,610,83,28,2,2057,,
NH,Concord Ward 5,1789,674,75,22,0,2560,,
NH,Concord Ward 6,1137,624,99,32,3,1895,,
NH,Concord Ward 7,1675,801,82,37,1,2596,,
NH,Concord Ward 8,1069,888,71,18,0,2046,,
NH,Concord Ward 9,1136,721,58,15,3,1933,,
NH,Conway,2717,2204,209,57,2,5189,,
NH,Cornish,570,400,35,7,0,1012,,
NH,Croydon,126,271,19,4,0,420,,
NH,Dalton,192,280,18,5,0,495,,
NH,Danbury,247,386,30,16,0,679,,
NH,Danville,860,1580,102,20,3,2565,,
NH,Deerfield,1091,1607,138,14,3,2853,,
NH,Deering,383,586,55,10,1,1035,,
NH,Derry,6825,9237,715,123,13,16913,,
NH,Dixville,4,2,1,0,0,7,,
NH,Dorchester,51,136,15,12,0,214,,
NH,Dover Ward 1,1863,733,139,49,5,2789,,
NH,Dover Ward 2,1903,856,144,43,1,2947,,
NH,Dover Ward 3,1960,1298,139,29,6,3432,,
NH,Dover Ward 4,1763,1152,153,22,2,3092,,
NH,Dover Ward 5,1381,951,139,29,2,2502,,
NH,Dover Ward 6,1248,1025,100,11,5,2389,,
NH,Dublin,598,370,40,6,2,1016,,
NH,Dummer,65,99,6,2,0,172,,
NH,Dunbarton,681,1026,69,9,2,1787,,
NH,Durham,6501,2450,455,119,5,9530,,
NH,East Kingston,608,830,88,9,2,1537,,
NH,Easton,118,65,7,3,0,193,,
NH,Eaton,157,109,14,2,0,282,,
NH,Effingham,317,481,38,6,0,842,,
NH,Ellsworth,26,24,5,2,0,57,,
NH,Enfield,1445,931,119,25,1,2521,,
NH,Epping,1625,2117,179,35,3,3959,,
NH,Epsom,919,1546,127,21,2,2615,,
NH,Errol,54,135,6,0,0,195,,
NH,Exeter,5514,3286,373,72,3,9248,,
NH,Farmington,1127,1785,154,30,4,3100,,
NH,Fitzwilliam,577,623,52,0,0,1252,,
NH,Francestown,471,444,28,20,0,963,,
NH,Franconia,483,233,18,9,0,743,,
NH,Franklin Ward 1,479,780,61,8,0,1328,,
NH,Franklin Ward 2,391,512,60,17,1,981,,
NH,Franklin Ward 3,617,757,49,15,2,1440,,
NH,Freedom,425,476,36,14,1,952,,
NH,Fremont,965,1591,137,14,2,2709,,
NH,Gilford,1973,2504,159,31,1,4668,,
NH,Gilmanton,788,1333,108,21,1,2251,,
NH,Gilsum,197,231,13,9,0,450,,
NH,Goffstown,4146,5009,412,57,7,9631,,
NH,Gorham,770,693,58,11,1,1533,,
NH,Goshen,153,260,16,8,1,438,,
NH,Grafton,267,397,33,8,1,706,,
NH,Grantham,1265,699,54,16,2,2036,,
NH,Green's Grant,1,0,0,0,0,1,,
NH,Greenfield,433,414,52,13,0,912,,
NH,Greenland,1396,1074,101,13,3,2587,,
NH,Greenville,379,493,46,11,9,938,,
NH,Groton,112,196,13,2,0,323,,
NH,Hale's Location,26,97,0,0,0,123,,
NH,Hampstead,1966,3186,191,42,3,5388,,
NH,Hampton,4953,4802,333,68,5,10161,,
NH,Hampton Falls,672,822,63,9,0,1566,,
NH,Hancock,713,433,39,6,5,1196,,
NH,Hanover,6561,926,189,50,1,7727,,
NH,Harrisville,446,202,21,7,1,677,,
NH,Hart's Location,17,14,3,0,0,34,,
NH,Haverhill,785,1186,106,21,4,2102,,
NH,Hebron,175,238,13,2,0,428,,
NH,Henniker,1429,1060,134,38,2,2663,,
NH,Hill,176,341,17,5,0,539,,
NH,Hillsborough,1198,1588,153,25,2,2966,,
NH,Hinsdale,917,733,47,21,4,1722,,
NH,Holderness,704,546,43,9,4,1306,,
NH,Hollis,2529,2310,251,47,1,5138,,
NH,Hooksett,3436,4225,292,53,4,8010,,
NH,Hopkinton,2240,1427,138,38,2,3845,,
NH,Hudson,5306,7220,545,96,16,13183,,
NH,Jackson,430,212,28,5,0,675,,
NH,Jaffrey,1311,1284,150,39,5,2789,,
NH,Jefferson,216,357,24,5,0,602,,
NH,Keene Ward 1,1462,640,97,46,3,2248,,
NH,Keene Ward 2,1648,692,86,40,4,2470,,
NH,Keene Ward 3,1424,736,84,32,1,2277,,
NH,Keene Ward 4,1581,791,87,42,0,2501,,
NH,Keene Ward 5,1817,972,107,38,2,2936,,
NH,Kensington,642,668,61,11,0,1382,,
NH,Kingston,1422,2081,154,31,1,3689,,
NH,Laconia Ward 1,621,868,68,9,0,1566,,
NH,Laconia Ward 2,469,612,46,7,3,1137,,
NH,Laconia Ward 3,637,604,49,12,0,1302,,
NH,Laconia Ward 4,490,632,53,19,3,1197,,
NH,Laconia Ward 5,416,561,44,11,2,1034,,
NH,Laconia Ward 6,670,1026,71,14,6,1787,,
NH,Lancaster,657,841,58,23,4,1583,,
NH,Landaff,105,127,9,1,5,247,,
NH,Langdon,184,197,8,1,0,390,,
NH,Lebanon Ward 1,1670,578,71,27,3,2349,,
NH,Lebanon Ward 2,1542,606,74,40,2,2264,,
NH,Lebanon Ward 3,1686,657,94,39,3,2479,,
NH,Lee,1630,824,124,33,5,2616,,
NH,Lempster,226,428,16,10,0,680,,
NH,Lincoln,408,367,45,13,2,835,,
NH,Lisbon,262,395,35,6,1,699,,
NH,Litchfield,1923,2720,227,36,4,4910,,
NH,Littleton,1241,1436,120,36,0,2833,,
NH,Londonderry,5968,7338,647,81,15,14049,,
NH,Loudon,1136,1950,146,12,3,3247,,
NH,Lyman,126,169,14,4,0,313,,
NH,Lyme,890,232,32,11,1,1166,,
NH,Lyndeborough,470,503,64,14,9,1060,,
NH,Madbury,632,422,67,10,0,1131,,
NH,Madison,721,654,70,13,5,1463,,
NH,Manchester Ward 1,2988,2231,215,39,4,5477,,
NH,Manchester Ward 10,1990,1844,188,28,1,4051,,
NH,Manchester Ward 11,1695,1378,163,40,8,3284,,
NH,Manchester Ward 12,2149,1910,177,45,5,4286,,
NH,Manchester Ward 2,2461,1976,212,46,1,4696,,
NH,Manchester Ward 3,1834,983,130,33,4,2984,,
NH,Manchester Ward 4,1875,1372,170,47,1,3465,,
NH,Manchester Ward 5,1571,1078,142,38,4,2833,,
NH,Manchester Ward 6,2220,2493,193,32,8,4946,,
NH,Manchester Ward 7,1962,1700,148,39,7,3856,,
NH,Manchester Ward 8,2144,2633,180,35,8,5000,,
NH,Manchester Ward 9,2052,1956,163,32,5,4208,,
NH,Marlborough,711,408,34,10,2,1165,,
NH,Marlow,219,200,19,2,1,441,,
NH,Mason,306,477,65,6,1,855,,
NH,Meredith,1709,2160,156,29,5,4059,,
NH,Merrimack,6405,7397,734,103,14,14653,,
NH,Middleton,289,602,24,5,2,922,,
NH,Milan,298,414,24,8,0,744,,
NH,Milford,3816,3850,398,73,5,8142,,
NH,Millsfield,4,16,0,0,0,20,,
NH,Milton,847,1339,94,20,1,2301,,
NH,Monroe,173,291,20,5,0,489,,
NH,Mont Vernon,757,686,71,12,0,1526,,
NH,Moultonborough,1148,1888,126,16,0,3178,,
NH,Nashua Ward 1,2946,2487,232,47,6,5718,,
NH,Nashua Ward 2,2483,1977,200,33,3,4696,,
NH,Nashua Ward 3,2482,1769,201,41,3,4496,,
NH,Nashua Ward 4,2077,1117,135,30,4,3363,,
NH,Nashua Ward 5,2752,2573,239,49,3,5616,,
NH,Nashua Ward 6,2307,1701,149,40,5,4202,,
NH,Nashua Ward 7,2171,1692,163,31,4,4061,,
NH,Nashua Ward 8,2688,2002,219,41,3,4953,,
NH,Nashua Ward 9,2784,2158,184,38,6,5170,,
NH,Nelson,259,138,17,9,0,423,,
NH,New Boston,1381,1792,161,23,3,3360,,
NH,New Castle,481,279,31,6,0,797,,
NH,New Durham,578,981,69,13,2,1643,,
NH,New Hampton,544,737,69,10,0,1360,,
NH,New Ipswich,769,1894,138,14,3,2818,,
NH,New London,1807,1101,95,24,0,3027,,
NH,Newbury,621,662,61,5,0,1349,,
NH,Newfields,603,474,45,11,0,1133,,
NH,Newington,271,292,23,4,0,590,,
NH,Newmarket,3157,1836,291,70,10,5364,,
NH,Newport,1085,1665,125,25,4,2904,,
NH,Newton,991,1593,114,15,4,2717,,
NH,North Hampton,1562,1448,104,23,0,3137,,
NH,Northfield,884,1330,105,29,4,2352,,
NH,Northumberland,387,539,42,18,4,990,,
NH,Northwood,1056,1385,127,12,1,2581,,
NH,Nottingham,1365,1511,165,30,2,3073,,
NH,Orange,73,85,6,2,0,166,,
NH,Orford,417,256,30,14,2,719,,
NH,Ossipee,770,1294,94,18,2,2178,,
NH,Pelham,2719,4624,254,52,4,7653,,
NH,Pembroke,1810,1919,179,33,5,3946,,
NH,Peterborough,2487,1179,170,55,1,3892,,
NH,Piermont,179,175,24,3,0,381,,
NH,Pinkham's Grant,3,0,0,0,0,3,,
NH,Pittsburg,121,343,5,3,0,472,,
NH,Pittsfield,691,1125,99,19,1,1935,,
NH,Plainfield,957,458,61,12,0,1488,,
NH,Plaistow,1672,2531,154,39,3,4399,,
NH,Plymouth,2143,1394,191,58,8,3794,,
NH,Portsmouth Ward 1,1839,789,115,28,2,2773,,
NH,Portsmouth Ward 2,2296,678,113,31,1,3119,,
NH,Portsmouth Ward 3,1528,779,87,11,0,2405,,
NH,Portsmouth Ward 4,1374,812,78,23,4,2291,,
NH,Portsmouth Ward 5,1874,574,114,19,0,2581,,
NH,Randolph,160,79,7,2,1,249,,
NH,Raymond,1921,3151,224,49,3,5348,,
NH,Richmond,269,357,34,5,0,665,,
NH,Rindge,1292,1961,163,24,4,3444,,
NH,Rochester Ward 1,1071,1407,134,21,2,2635,,
NH,Rochester Ward 2,1150,1425,147,15,1,2738,,
NH,Rochester Ward 3,1017,1370,131,27,1,2546,,
NH,Rochester Ward 4,1048,1190,103,25,5,2371,,
NH,Rochester Ward 5,1034,1388,117,13,2,2554,,
NH,Rochester Ward 6,947,1009,110,25,0,2091,,
NH,Rollinsford,769,711,83,18,1,1582,,
NH,Roxbury,72,58,6,3,0,139,,
NH,Rumney,365,457,36,12,1,871,,
NH,Rye,2211,1579,165,24,1,3980,,
NH,Salem,6068,9312,503,92,11,15986,,
NH,Salisbury,288,490,25,9,0,812,,
NH,Sanbornton,748,1035,76,34,2,1895,,
NH,Sandown,1207,2144,178,23,5,3557,,
NH,Sandwich,578,360,34,13,1,986,,
NH,Seabrook,1595,2743,132,19,5,4494,,
NH,Sharon,132,94,11,4,0,241,,
NH,Shelburne,125,116,10,0,0,251,,
NH,Somersworth Ward 1,683,624,67,11,3,1388,,
NH,Somersworth Ward 2,523,488,34,16,0,1061,,
NH,Somersworth Ward 3,500,513,45,7,0,1065,,
NH,Somersworth Ward 4,533,437,38,10,1,1019,,
NH,Somersworth Ward 5,404,327,32,15,1,779,,
NH,South Hampton,246,315,19,3,2,585,,
NH,Springfield,344,422,44,7,0,817,,
NH,Stark,98,186,6,3,0,293,,
NH,Stewartstown,95,231,19,4,1,350,,
NH,Stoddard,350,378,28,8,1,765,,
NH,Strafford,1118,1296,107,13,1,2535,,
NH,Stratford,132,126,5,3,0,266,,
NH,Stratham,2593,2005,218,36,5,4857,,
NH,Sugar Hill,237,159,15,10,0,421,,
NH,Sullivan,196,172,25,3,0,396,,
NH,Sunapee,928,1044,83,23,2,2080,,
NH,Surry,237,244,14,4,0,499,,
NH,Sutton,607,560,52,13,2,1234,,
NH,Swanzey,1807,1828,144,34,3,3816,,
NH,Tamworth,739,761,69,24,2,1595,,
NH,Temple,405,400,32,16,8,861,,
NH,Thornton,736,651,88,14,0,1489,,
NH,Tilton,780,973,75,19,2,1849,,
NH,Troy,422,509,60,8,0,999,,
NH,Tuftonboro,674,891,55,17,0,1637,,
NH,Unity,281,473,29,13,1,797,,
NH,Wakefield,873,1741,111,20,0,2745,,
NH,Walpole,1169,755,104,27,3,2058,,
NH,Warner,874,790,83,31,1,1779,,
NH,Warren,180,261,14,5,0,460,,
NH,Washington,247,400,29,10,0,686,,
NH,Waterville Valley,150,99,8,1,1,259,,
NH,Weare,1734,2957,281,62,8,5042,,
NH,Webster,499,602,40,3,2,1146,,
NH,Wentworth,175,323,16,5,0,519,,
NH,Wentworth's Location,5,13,0,0,0,18,,
NH,Westmoreland,555,411,41,11,1,1019,,
NH,Whitefield,472,563,53,24,2,1114,,
NH,Wilmot,499,342,40,1,1,883,,
NH,Wilton,1028,1061,108,34,1,2232,,
NH,Winchester,840,829,75,25,0,1769,,
NH,Windham,3507,4825,372,46,10,8760,,
NH,Windsor,28,94,2,1,0,125,,
NH,Wolfeboro,1871,2176,157,36,4,4244,,
NH,Woodstock,378,335,43,3,0,759,,
NJ,ATLANTIC,60924,52690,2109,999,569,117291,,
NJ,BERGEN,231211,175529,7764,3988,804,419296,,
NJ,BURLINGTON,121725,89272,4946,2349,651,218943,,
NJ,CAMDEN,146717,72631,4245,2003,996,226592,,
NJ,CAPE MAY,18750,28446,903,390,233,48722,,
NJ,CUMBERLAND,27771,24453,1043,489,248,54004,,
NJ,ESSEX,240837,63176,3111,2921,889,310934,,
NJ,GLOUCESTER,66870,67544,3216,1256,656,139542,,
NJ,HUDSON,163917,49043,2922,2657,836,219375,,
NJ,HUNTERDON,28898,38712,2213,805,208,70836,,
NJ,MERCER,104775,46193,3267,1677,617,156529,,
NJ,MIDDLESEX,193044,122953,5446,3452,1207,326102,,
NJ,MONMOUTH,137181,166723,6388,3189,896,314377,,
NJ,MORRIS,115249,126071,5943,2532,621,250416,,
NJ,OCEAN,87150,179079,4867,2122,1144,274362,,
NJ,PASSAIC,116759,72902,2541,1948,652,194802,,
NJ,SALEM,11904,16381,862,238,109,29494,,
NJ,SOMERSET,85689,65505,3776,1568,554,157092,,
NJ,SUSSEX,24212,46658,2026,845,385,74126,,
NJ,UNION,147414,68114,3628,1779,1040,221975,,
NJ,WARREN,17281,29858,1261,565,271,49236,,
NM,Bernalillo,143417,94698,29682,3614,3251,274662,,
NM,Catron,427,1464,111,23,24,2049,,
NM,Chaves,5534,12872,1609,86,170,20271,,
NM,Cibola,3741,3195,970,73,84,8063,,
NM,Colfax,2129,2585,527,37,54,5332,,
NM,Curry,3121,9035,973,74,167,13370,,
NM,De Baca,193,620,89,6,2,910,,
NM,Dona Ana,37947,25374,5471,953,903,70648,,
NM,Eddy,5033,13147,1275,84,128,19667,,
NM,Grant,6276,5288,899,218,130,12811,,
NM,Guadalupe,970,595,238,18,6,1827,,
NM,Harding,156,311,55,3,2,527,,
NM,Hidalgo,784,910,137,6,35,1872,,
NM,Lea,3930,12495,1098,56,133,17712,,
NM,Lincoln,2331,5896,560,59,56,8902,,
NM,Los Alamos,5562,3359,1512,120,332,10885,,
NM,Luna,3195,3478,481,66,75,7295,,
NM,McKinley,13576,5104,2412,284,327,21703,,
NM,Mora,1536,665,194,35,11,2441,,
NM,Otero,6124,11886,1613,169,267,20059,,
NM,Quay,1017,2212,299,15,29,3572,,
NM,Rio Arriba,9592,3599,1425,188,74,14878,,
NM,Roosevelt,1454,3884,482,48,82,5950,,
NM,San Juan,12865,27946,4200,352,747,46110,,
NM,San Miguel,7285,2313,915,160,78,10751,,
NM,Sandoval,27707,25905,6657,627,794,61690,,
NM,Santa Fe,50793,14332,4362,1452,495,71434,,
NM,Sierra,1612,3010,442,78,39,5181,,
NM,Socorro,3313,2616,802,60,77,6868,,
NM,Taos,10668,2727,1179,617,69,15260,,
NM,Torrance,1785,3714,692,66,67,6324,,
NM,Union,320,1216,134,13,19,1702,,
NM,Valencia,10841,13215,3046,219,271,27592,,
NV,Carson City,9610,13125,1159,NA,1122,25016,,
NV,Churchill,2210,7830,450,NA,448,10938,,
NV,Clark,402227,320057,22453,NA,22419,767156,,
NV,Douglas,8454,17415,1004,NA,1012,27885,,
NV,Elko,3401,13551,828,NA,779,18559,,
NV,Esmeralda,65,329,15,NA,14,423,,
NV,Eureka,74,723,19,NA,38,854,,
NV,Humboldt,1386,4521,269,NA,257,6433,,
NV,Lander,403,1828,79,NA,103,2413,,
NV,Lincoln,285,1671,62,NA,114,2132,,
NV,Lyon,6146,16005,813,NA,798,23762,,
NV,Mineral,637,1179,88,NA,93,1997,,
NV,Nye,5094,13324,552,NA,625,19595,,
NV,Pershing,430,1403,58,NA,91,1982,,
NV,Storey,752,1616,100,NA,90,2558,,
NV,Washoe,97379,94758,9284,NA,8488,209909,,
NV,White Pine,707,2723,151,NA,192,3773,,
NY,Albany,83080,47810,4792,2474,3257,141413,,
NY,Allegany,4882,12525,735,275,455,18872,,
NY,Bronx,353646,37797,2312,4341,4881,402977,,
NY,Broome,39212,40943,3246,1546,2230,87177,,
NY,Cattaraugus,9497,19692,1246,440,678,31553,,
NY,Cayuga,13522,17384,1358,501,682,33447,, 
NY,Chautauqua,19091,31594,2203,757,1165,54810,,
NY,Chemung,13757,20097,1447,463,750,36514,,
NY,Chenango,6775,11921,916,358,349,20319,,
NY,Clinton,15059,14449,1312,613,3103,34536,,
NY,Columbia,15284,13756,944,598,570,31152,,
NY,Cortland,8771,9900,957,374,451,20453,,
NY,Delaware,6627,11942,650,377,336,19932,,
NY,Dutchess,62261,61797,3600,1986,2590,132234,,
NY,Erie,215460,188303,12720,6367,8687,431537,,
NY,Essex,7764,7958,728,420,592,17462,,
NY,Franklin,7297,8221,717,359,595,17189,,
NY,Fulton,6496,13462,779,311,416,21464,,
NY,Genesee,7650,16915,1319,324,468,26676,,
NY,Greene,7405,13073,647,442,758,22325,,
NY,Hamilton,949,2064,119,44,101,3277,,
NY,Herkimer,8083,16699,1002,403,510,26697,,
NY,Jefferson,13809,21763,1670,617,754,38613,,
NY,Kings,640566,141044,6864,11932,10099,810505,,
NY,Lewis,3146,7400,496,132,281,11455,,
NY,Livingston,10698,17290,1276,449,600,30313,,
NY,Madison,11667,15936,1582,516,652,30353,,
NY,Monroe,188594,136582,13205,5289,7298,350968,,
NY,Montgomery,6595,11301,690,268,420,19274,,
NY,Nassau,326094,288313,11146,6648,10347,642548,,
NY,New York,579019,64929,9408,9441,10314,673111,,
NY,Niagara,35559,51961,2865,1287,2621,94293,,
NY,Oneida,33743,51437,3754,1235,1743,91912,,
NY,Onondaga,112337,83649,8524,3185,5169,212864,,
NY,Ontario,22233,26029,2486,852,1091,52691,,
NY,Orange,68281,76645,3867,2154,5719,156666,,
NY,Orleans,4470,10936,680,184,299,16569,,
NY,Oswego,17096,27688,2137,705,921,48547,,
NY,Otsego,10451,13308,1066,520,592,25937,,
NY,Putnam,19368,27024,1171,590,712,48865,,
NY,Queens,517229,149341,7116,9230,8293,691209,,
NY,Rensselaer,32722,33726,2944,1355,1388,72135,,
NY,Richmond,74146,101437,2432,1886,2219,182120,,
NY,Rockland,69343,60911,2284,1348,4163,138049,,
NY,Saratoga,50913,54575,5116,1825,2689,115118,,
NY,Schenectady,33752,28953,2624,1127,1449,67905,,
NY,Schoharie,4240,8831,531,274,289,14165,,
NY,Schuyler,3091,5050,309,216,167,8833,,
NY,Seneca,5697,7236,638,259,260,14090,,
NY,St. Lawrence,16488,19942,1445,807,950,39632,,
NY,Steuben,12526,26831,1666,585,726,42334,,
NY,Suffolk,303614,350327,13909,8093,10530,686473,,
NY,Sullivan,12568,15931,734,504,747,30484,,
NY,Tioga,7526,13260,930,337,502,22555,,
NY,Tompkins,28890,10371,1393,1380,1005,43039,,
NY,Ulster,42107,34006,2281,2061,2493,82948,,
NY,Warren,13091,15751,1255,863,756,31716,,
NY,Washington,9098,13610,926,578,561,24773,,
NY,Wayne,13473,23380,1911,567,678,40009,,
NY,Westchester,272932,131238,8042,4358,7485,424055,,
NY,Wyoming,3904,12442,673,180,302,17501,,
NY,Yates,3659,5660,494,146,262,10221,,
OH,Adams,2326,8659,226,47,101,11359,,
OH,Allen,13294,30487,1486,323,304,45894,,
OH,Ashland,5740,17493,906,185,266,24590,,
OH,Ashtabula,15577,23318,1213,427,332,40867,,
OH,Athens,16370,11354,1012,539,168,29443,,
OH,Auglaize,3980,18658,701,112,176,23627,,
OH,Belmont,8785,21108,777,195,257,31122,,
OH,Brown,4353,14573,431,103,147,19607,,
OH,Butler,58642,106976,5790,1173,1258,173839,,
OH,Carroll,3154,9254,450,91,125,13074,,
OH,Champaign,4594,12631,582,147,150,18104,,
OH,Clark,23328,35205,1895,511,490,61429,,
OH,Clermont,26715,67518,3504,728,656,99121,,
OH,Clinton,4066,13838,514,127,130,18675,,
OH,Columbiana,12432,31676,1401,320,372,46201,,
OH,Coshocton,4013,10785,468,118,168,15552,,
OH,Crawford,4625,13611,714,119,168,19237,,
OH,Cuyahoga,398271,184211,12993,5242,3105,603822,,
OH,Darke,4470,20012,649,149,204,25484,,
OH,Defiance,5368,11688,782,153,201,18192,,
OH,Delaware,40872,57568,4116,668,636,103860,,
OH,Erie,16057,19648,1225,342,306,37578,,
OH,Fairfield,24881,44314,2439,558,721,72913,,
OH,Fayette,2739,7995,295,57,76,11162,,
OH,Franklin,351198,199331,19725,6106,4780,581140,,
OH,Fulton,6069,13709,1024,167,256,21225,,
OH,Gallia,2628,9822,285,98,98,12931,,
OH,Geauga,17569,30227,1502,333,310,49941,,
OH,Greene,28943,48540,3277,680,418,81858,,
OH,Guernsey,4359,11445,549,99,105,16557,,
OH,Hamilton,215719,173665,13200,3723,2802,409109,,
OH,Hancock,9609,24183,1535,319,377,36023,,
OH,Hardin,2920,8717,465,80,112,12294,,
OH,Harrison,1688,5098,178,53,62,7079,,
OH,Henry,3756,9301,659,111,105,13932,,
OH,Highland,3773,14020,473,103,132,18501,,
OH,Hocking,3775,8497,367,90,109,12838,,
OH,Holmes,1788,8720,374,53,119,11054,,
OH,Huron,7192,16226,923,192,301,24834,,
OH,Jackson,3226,9949,373,64,81,13693,,
OH,Jefferson,9675,21117,841,194,374,32201,,
OH,Knox,8171,19131,936,208,241,28687,,
OH,Lake,46397,64255,3833,946,815,116246,,
OH,Lawrence,6974,18689,589,160,195,26607,,
OH,Licking,27376,51241,2708,725,711,82761,,
OH,Logan,4647,15957,657,129,181,21571,,
OH,Lorain,66949,66818,4548,1255,992,140562,,
OH,Lucas,110833,75698,7410,2252,1363,197556,,
OH,Madison,4779,11631,600,110,170,17290,,
OH,Mahoning,57381,53616,2606,874,595,115072,,
OH,Marion,7928,16961,986,238,209,26322,,
OH,Medina,32182,54810,2975,709,697,91373,,
OH,Meigs,2260,7309,280,66,70,9985,,
OH,Mercer,3384,17506,562,110,164,21726,,
OH,Miami,13120,37079,1837,315,383,52734,,
OH,Monroe,1662,4868,162,36,67,6795,,
OH,Montgomery,122016,123909,8387,2282,1707,258301,,
OH,Morgan,1736,4431,192,45,39,6443,,
OH,Morrow,3761,11948,569,102,168,16548,,
OH,Muskingum,11123,24056,1244,261,307,36991,,
OH,Noble,1221,4549,152,34,57,6013,,
OH,Ottawa,8285,12653,957,147,176,22218,,
OH,Paulding,2093,6500,279,78,97,9047,,
OH,Perry,4138,10228,405,103,121,14995,,
OH,Pickaway,6529,17076,756,180,204,24745,,
OH,Pike,3539,7902,283,58,97,11879,,
OH,Portage,32397,39971,2415,840,516,76139,,
OH,Preble,4325,15446,553,126,115,20565,,
OH,Putnam,2922,14961,638,72,174,18767,,
OH,Richland,16085,36590,1637,387,515,55214,,
OH,Ross,10356,18652,934,209,229,30380,,
OH,Sandusky,9929,16316,1263,311,225,28044,,
OH,Scioto,9132,20550,699,217,186,30784,,
OH,Seneca,7404,14825,1302,242,214,23987,,
OH,Shelby,4243,18590,594,125,188,23740,,
OH,Stark,68146,98388,5693,1393,1619,175239,,
OH,Summit,134256,112026,7472,2330,1895,257979,,
OH,Trumbull,43014,49024,2489,849,653,96029,,
OH,Tuscarawas,12188,26918,1606,287,290,41289,,
OH,Union,7718,18096,1119,207,289,27429,,
OH,Van Wert,2697,10469,429,105,70,13770,,
OH,Vinton,1351,3883,168,43,57,5502,,
OH,Warren,33730,77643,4335,715,844,117267,,
OH,Washington,8026,20514,892,208,200,29840,,
OH,Wayne,15031,32270,1624,379,549,49853,,
OH,Williams,4358,11939,703,130,178,17308,,
OH,Wood,27318,32498,3264,689,572,64341,,
OH,Wyandot,2515,7468,437,85,87,10592,,
OK,ADAIR,1382,4787,344,NA,NA,6513,,
OK,ALFALFA,216,1933,109,NA,NA,2258,,
OK,ATOKA,795,4084,139,NA,NA,5018,,
OK,BEAVER,176,1993,74,NA,NA,2243,,
OK,BECKHAM,960,6308,284,NA,NA,7552,,
OK,BLAINE,711,2884,198,NA,NA,3793,,
OK,BRYAN,2804,10478,536,NA,NA,13818,,
OK,CADDO,2420,6482,446,NA,NA,9348,,
OK,CANADIAN,11674,39986,3618,NA,NA,55278,,
OK,CARTER,4002,13752,780,NA,NA,18534,,
OK,CHEROKEE,5456,9994,1040,NA,NA,16490,,
OK,CHOCTAW,1067,4206,153,NA,NA,5426,,
OK,CIMARRON,71,963,45,NA,NA,1079,,
OK,CLEVELAND,38829,62538,8083,NA,NA,109450,,
OK,COAL,411,1898,90,NA,NA,2399,,
OK,COMANCHE,11463,19183,1918,NA,NA,32564,,
OK,COTTON,424,2054,124,NA,NA,2602,,
OK,CRAIG,1252,4283,250,NA,NA,5785,,
OK,CREEK,5841,21575,1414,NA,NA,28830,,
OK,CUSTER,2104,7826,611,NA,NA,10541,,
OK,DELAWARE,3311,11826,579,NA,NA,15716,,
OK,DEWEY,222,1965,61,NA,NA,2248,,
OK,ELLIS,155,1611,61,NA,NA,1827,,
OK,GARFIELD,4397,16009,1304,NA,NA,21710,,
OK,GARVIN,1855,8253,438,NA,NA,10546,,
OK,GRADY,3882,17316,1088,NA,NA,22286,,
OK,GRANT,288,1827,86,NA,NA,2201,,
OK,GREER,323,1482,91,NA,NA,1896,,
OK,HARMON,225,715,37,NA,NA,977,,
OK,HARPER,134,1318,47,NA,NA,1499,,
OK,HASKELL,882,3701,155,NA,NA,4738,,
OK,HUGHES,961,3388,177,NA,NA,4526,,
OK,JACKSON,1473,5969,364,NA,NA,7806,,
OK,JEFFERSON,365,1910,75,NA,NA,2350,,
OK,JOHNSTON,786,3093,139,NA,NA,4018,,
OK,KAY,3738,12172,893,NA,NA,16803,,
OK,KINGFISHER,786,5156,189,NA,NA,6131,,
OK,KIOWA,767,2596,130,NA,NA,3493,,
OK,LATIMER,797,3100,159,NA,NA,4056,,
OK,LEFLORE,3250,13362,609,NA,NA,17221,,
OK,LINCOLN,2430,10854,741,NA,NA,14025,,
OK,LOGAN,4248,13633,1098,NA,NA,18979,,
OK,LOVE,735,2922,132,NA,NA,3789,,
OK,MAJOR,310,2948,149,NA,NA,3407,,
OK,MARSHALL,1096,4206,190,NA,NA,5492,,
OK,MAYES,3423,11555,739,NA,NA,15717,,
OK,MCCLAIN,2894,13169,795,NA,NA,16858,,
OK,MCCURTAIN,1802,8656,268,NA,NA,10726,,
OK,MCINTOSH,2123,5505,335,NA,NA,7963,,
OK,MURRAY,1087,4175,266,NA,NA,5528,,
OK,MUSKOGEE,7977,15043,1196,NA,NA,24216,,
OK,NOBLE,901,3715,262,NA,NA,4878,,
OK,NOWATA,742,3321,174,NA,NA,4237,,
OK,OKFUSKEE,943,2800,200,NA,NA,3943,,
OK,OKLAHOMA,112813,141569,19560,NA,NA,273942,,
OK,OKMULGEE,4385,8944,620,NA,NA,13949,,
OK,OSAGE,5597,12577,792,NA,NA,18966,,
OK,OTTAWA,2584,7631,475,NA,NA,10690,,
OK,PAWNEE,1344,4729,291,NA,NA,6364,,
OK,PAYNE,8788,16651,2321,NA,NA,27760,,
OK,PITTSBURG,3711,12753,807,NA,NA,17271,,
OK,PONTOTOC,3637,10431,763,NA,NA,14831,,
OK,POTTAWATOMIE,6015,17848,1589,NA,NA,25452,,
OK,PUSHMATAHA,748,3581,154,NA,NA,4483,,
OK,ROGER MILLS,151,1547,61,NA,NA,1759,,
OK,ROGERS,7902,30913,2047,NA,NA,40862,,
OK,SEMINOLE,2071,5613,353,NA,NA,8037,,
OK,SEQUOYAH,3061,10888,488,NA,NA,14437,,
OK,STEPHENS,3086,14182,636,NA,NA,17904,,
OK,TEXAS,858,4621,301,NA,NA,5780,,
OK,TILLMAN,657,1944,105,NA,NA,2706,,
OK,TULSA,87847,144258,14949,NA,NA,247054,,
OK,WAGONER,6723,23005,1572,NA,NA,31300,,
OK,WASHINGTON,5048,15825,1351,NA,NA,22224,,
OK,WASHITA,588,3854,189,NA,NA,4631,,
OK,WOODS,522,2947,199,NA,NA,3668,,
OK,WOODWARD,873,6347,375,NA,NA,7595,,
OR,Baker,1797,6218,413,134,217,8779,,
OR,Benton,29193,13445,2692,1595,1828,48753,,
OR,Clackamas,102095,88392,11053,4001,8498,214039,,
OR,Clatsop,9252,8138,973,569,732,19664,,
OR,Columbia,10167,13217,1646,572,1016,26618,,
OR,Coos,10448,17865,1411,755,834,31313,,
OR,Crook,2637,8511,518,157,349,12172,,
OR,Curry,4300,7212,498,273,328,12611,,
OR,Deschutes,42444,45692,5158,1998,3265,98557,,
OR,Douglas,14096,34582,2413,1021,1409,53521,,
OR,Gilliam,239,671,79,7,23,1019,,
OR,Grant,739,3210,209,48,134,4340,,
OR,Harney,683,2912,222,42,115,3974,,
OR,Hood River,6510,3272,511,300,317,10910,,
OR,Jackson,44447,53870,4373,2996,3641,109327,,
OR,Jefferson,2980,5483,493,182,321,9459,,
OR,Josephine,13453,26923,1829,1057,1298,44560,,
OR,Klamath,7210,20435,1525,508,829,30507,,
OR,Lake,639,3022,151,42,76,3930,,
OR,Lane,102753,67141,8476,6302,7278,191950,,
OR,Lincoln,12501,10039,1130,748,838,25256,,
OR,Linn,17995,33488,3431,1339,2466,58719,,
OR,Malheur,2246,7194,427,177,391,10435,,
OR,Marion,57788,63377,7058,2868,5749,136840,,
OR,Morrow,1017,2721,238,52,139,4167,,
OR,Multnomah,292561,67954,12862,12969,12757,399103,,
OR,Polk,16420,18940,2254,907,1774,40295,,
OR,Sherman,202,732,44,11,28,1017,,
OR,Tillamook,5768,6538,760,333,404,13803,,
OR,Umatilla,7673,17059,1457,489,919,27597,,
OR,Union,3249,8431,673,198,417,12968,,
OR,Wallowa,1116,2848,179,82,141,4366,,
OR,Wasco,4781,5833,689,239,422,11964,,
OR,Washington,153251,83197,15266,6005,11513,269232,,
OR,Wheeler,155,591,46,10,16,818,,
OR,Yamhill,19301,23250,3074,1016,2112,48753,,
PA,ADAMS,14219,31423,1251,405,191,47489,,
PA,ALLEGHENY,367617,259480,16102,5097,1818,650114,,
PA,ARMSTRONG,7178,23484,685,141,130,31618,,
PA,BEAVER,32531,48167,2022,496,355,83571,,
PA,BEDFORD,3645,19552,260,102,78,23637,,
PA,BERKS,78437,96626,5247,1974,781,183065,,
PA,BLAIR,13958,39135,1256,338,222,54909,,
PA,BRADFORD,6369,18141,893,137,168,25708,,
PA,BUCKS,167060,164361,8556,3121,1199,344297,,
PA,BUTLER,28584,64428,3062,615,382,97071,,
PA,CAMBRIA,18867,42258,1270,413,264,63072,,
PA,CAMERON,531,1589,53,6,7,2186,,
PA,CARBON,8936,18743,691,265,141,28776,,
PA,CENTRE,37088,35274,2644,798,344,76148,,
PA,CHESTER,141682,116114,7930,2247,827,268800,,
PA,CLARION,4273,12576,469,115,102,17535,,
PA,CLEARFIELD,8200,24932,776,220,143,34271,,
PA,CLINTON,4744,10022,470,121,37,15394,,
PA,COLUMBIA,8934,18004,883,265,142,28228,,
PA,CRAWFORD,10971,24987,1046,271,217,37492,,
PA,CUMBERLAND,47085,69076,3975,939,542,121617,,
PA,DAUPHIN,64706,60863,3498,1177,628,130872,,
PA,DELAWARE,177402,110667,5992,2588,985,297634,,
PA,ELK,3853,10025,401,79,68,14426,,
PA,ERIE,58112,60069,3871,1139,488,123679,,
PA,FAYETTE,17946,34590,853,232,146,53767,,
PA,FOREST,626,1683,60,19,13,2401,,
PA,FRANKLIN,17465,49768,1712,450,336,69731,,
PA,FULTON,912,5694,93,37,35,6771,,
PA,GREENE,4482,10849,284,83,66,15764,,
PA,HUNTINGDON,4539,14494,425,96,152,19706,,
PA,INDIANA,11528,24888,936,220,198,37770,,
PA,JEFFERSON,3650,15192,432,110,94,19478,,
PA,JUNIATA,1821,8273,201,71,88,10454,,
PA,LACKAWANNA,51983,48384,1935,896,258,103456,,
PA,LANCASTER,91093,137914,8555,2021,1529,241112,,
PA,LAWRENCE,14009,25428,870,248,198,40753,,
PA,LEBANON,18953,40525,1647,422,298,61845,,
PA,LEHIGH,81324,73690,4027,1402,550,160993,,
PA,LUZERNE,52451,78688,2339,1178,327,134983,,
PA,LYCOMING,13020,35627,1311,384,223,50565,,
PA,McKEAN,4025,11635,408,151,77,16296,,
PA,MERCER,18733,31544,1370,415,247,52309,,
PA,MIFFLIN,3877,14094,476,80,74,18601,,
PA,MONROE,33918,33386,1502,758,188,69752,,
PA,MONTGOMERY,256082,162731,10934,3704,1236,434687,,
PA,MONTOUR,2857,5288,287,73,51,8556,,
PA,NORTHAMPTON,66272,71736,3690,1371,450,143519,,
PA,NORTHUMBERLAND,9788,25427,931,296,180,36622,,
PA,PERRY,4632,15616,619,163,128,21158,,
PA,PHILADELPHIA,584025,108748,7115,6679,1064,707631,,
PA,PIKE,9256,16056,492,226,71,26101,,
PA,POTTER,1302,6251,165,35,31,7784,,
PA,SCHUYLKILL,16770,44001,1414,449,235,62869,,
PA,SNYDER,4002,11725,455,111,70,16363,,
PA,SOMERSET,7376,27379,678,166,174,35773,,
PA,SULLIVAN,750,2291,65,14,16,3136,,
PA,SUSQUEHANNA,5123,12891,568,192,89,18863,,
PA,TIOGA,3901,13614,548,139,123,18325,,
PA,UNION,6180,10622,450,143,73,17468,,
PA,VENANGO,6309,16021,733,149,136,23348,,
PA,WARREN,5145,12477,549,130,133,18434,,
PA,WASHINGTON,36322,61386,2643,733,366,101450,,
PA,WAYNE,7008,16244,466,206,94,24018,,
PA,WESTMORELAND,59669,116522,4367,936,557,182051,,
PA,WYOMING,3811,8837,323,116,57,13144,,
PA,YORK,68524,128528,6484,1568,882,205986,,
RI,barrington,6153,2898,340,110,257,9758,,
RI,bristol,5771,4080,428,134,252,10665,,
RI,burrillville,2558,4139,295,109,169,7270,,
RI,central falls,3394,657,86,40,59,4236,,
RI,charlestown,2207,1906,183,56,91,4443,,
RI,coventry,7032,9199,669,215,399,17514,,
RI,cranston,18763,15934,922,445,732,36796,,
RI,cumberland,8655,7444,618,180,340,17237,,
RI,east greenwich,4019,3122,283,59,206,7689,,
RI,east providence,11904,7134,631,263,478,20410,,
RI,exeter,1471,1820,144,56,95,3586,,
RI,foster,967,1374,99,36,58,2534,,
RI,glocester,1977,2914,179,90,103,5263,,
RI,hopkinton,1766,2135,161,63,101,4226,,
RI,jamestown,2172,1148,119,46,78,3563,,
RI,johnston,5652,7563,315,119,195,13844,,
RI,lincoln,5279,5410,362,138,219,11408,,
RI,little compton,1165,821,105,40,55,2186,,
RI,middletown,4248,2745,281,112,171,7557,,
RI,narragansett,4214,3292,275,100,196,8077,,
RI,new shoreham,609,214,19,16,33,891,,
RI,newport,6287,2644,332,144,251,9658,,
RI,north kingstown,7793,6147,660,238,418,15256,,
RI,north providence,7760,6936,380,162,273,15511,,
RI,north smithfield,2570,3242,226,75,138,6251,,
RI,pawtucket,15574,6221,533,268,405,23001,,
RI,portsmouth,4945,3922,405,128,258,9658,,
RI,providence,45053,7682,1094,863,947,55639,,
RI,richmond,1713,2058,185,58,113,4127,,
RI,scituate,2045,3536,208,77,139,6005,,
RI,smithfield,4402,5254,377,118,227,10378,,
RI,south kingstown,8677,4627,568,331,414,14617,,
RI,tiverton,4034,3797,287,120,185,8423,,
RI,warren,2685,1987,175,73,132,5052,,
RI,warwick,20038,18338,1466,581,1017,41440,,
RI,west greenwich,1159,1953,150,40,72,3374,,
RI,west warwick,5540,5724,375,154,243,12036,,
RI,westerly,5291,5031,348,144,332,11146,,
RI,woonsocket,6346,5442,447,202,254,12691,,
SC,Abbeville,3741,6763,129,36,106,10775,,
SC,Aiken,25455,46025,1798,460,1113,74851,,
SC,Allendale,2735,789,22,11,35,3592,,
SC,Anderson,21097,56232,1592,438,1124,80483,,
SC,Bamberg,3898,2204,51,17,44,6214,,
SC,Barnwell,4400,4889,87,35,74,9485,,
SC,Beaufort,32138,42922,2005,482,977,78524,,
SC,Berkeley,30705,44587,2470,543,1212,79517,,
SC,Calhoun,3573,3787,105,24,60,7549,,
SC,Charleston,89299,75443,7283,1681,2639,176345,,
SC,Cherokee,6092,15167,242,80,178,21759,,
SC,Chester,6579,7265,175,50,123,14192,,
SC,Chesterfield,6858,9312,185,47,179,16581,,
SC,Clarendon,7732,7386,127,27,123,15395,,
SC,Colleton,7627,9091,262,79,192,17251,,
SC,Darlington,13888,14989,385,133,279,29674,,
SC,Dillon,5834,5637,79,54,94,11698,,
SC,Dorchester,24055,34987,2050,447,1028,62567,,
SC,Edgefield,4491,6842,152,35,124,11644,,
SC,Fairfield,6945,4027,120,49,126,11267,,
SC,Florence,26710,29573,853,255,540,57931,,
SC,Georgetown,13310,17389,498,165,295,31657,,
SC,Greenville,74483,127832,6511,1495,4844,215165,,
SC,Greenwood,10711,16961,580,160,351,28763,,
SC,Hampton,5170,3488,69,19,60,8806,,
SC,Horry,39410,89288,2276,811,1135,132920,,
SC,Jasper,5956,5187,139,35,110,11427,,
SC,Kershaw,10330,17542,560,143,420,28995,,
SC,Lancaster,13812,23719,764,161,482,38938,,
SC,Laurens,8889,16816,373,125,363,26566,,
SC,Lee,5199,2803,63,22,69,8156,,
SC,Lexington,35230,80026,3584,894,2359,122093,,
SC,Marion,8569,5444,103,65,95,14276,,
SC,Marlboro,5954,4267,70,33,65,10389,,
SC,McCormick,2479,2652,47,8,30,5216,,
SC,Newberry,6217,10017,313,65,195,16807,,
SC,Oconee,7998,24178,725,225,509,33635,,
SC,Orangeburg,26318,11931,308,125,228,38910,,
SC,Pickens,10354,36236,1194,328,937,49049,,
SC,Richland,108000,52469,3938,1383,2932,168722,,
SC,Saluda,2813,5526,105,42,78,8564,,
SC,Spartanburg,39997,76277,2443,760,1613,121090,,
SC,Sumter,24047,18745,644,202,448,44086,,
SC,Union,4729,7061,137,48,117,12092,,
SC,Williamsburg,9953,4864,84,50,103,15054,,
SC,York,41593,66754,3504,687,1819,114357,,
SD,Aurora,340,974,74,NA,19,1407,,
SD,Beadle,1912,4455,323,NA,82,6772,,
SD,Bennett,412,666,57,NA,14,1149,,
SD,Bon Homme,704,2105,129,NA,36,2974,,
SD,Brookings,4879,6748,881,NA,172,12680,,
SD,Brown,5452,9613,915,NA,133,16113,,
SD,Brule,571,1565,125,NA,27,2288,,
SD,Buffalo,296,171,18,NA,5,490,,
SD,Butte,693,3355,246,NA,52,4346,,
SD,Campbell,105,704,20,NA,2,831,,
SD,Charles Mix,935,2382,98,NA,18,3433,,
SD,Clark,398,1139,103,NA,17,1657,,
SD,Clay,2608,2109,295,NA,57,5069,,
SD,Codington,3174,7764,600,NA,131,11669,,
SD,Corson,535,588,34,NA,18,1175,,
SD,Custer,1120,3290,255,NA,51,4716,,
SD,Davison,2355,5157,349,NA,91,7952,,
SD,Day,974,1627,116,NA,30,2747,,
SD,Deuel,570,1366,117,NA,27,2080,,
SD,Dewey,887,723,71,NA,26,1707,,
SD,Douglas,214,1338,41,NA,12,1605,,
SD,Edmunds,380,1433,86,NA,19,1918,,
SD,Fall River,821,2511,166,NA,65,3563,,
SD,Faulk,204,858,45,NA,11,1118,,
SD,Grant,970,2381,175,NA,36,3562,,
SD,Gregory,391,1600,78,NA,22,2091,,
SD,Haakon,77,936,27,NA,4,1044,,
SD,Hamlin,555,2051,124,NA,32,2762,,
SD,Hand,334,1391,76,NA,17,1818,,
SD,Hanson,424,1497,59,NA,26,2006,,
SD,Harding,38,694,31,NA,6,769,,
SD,Hughes,2449,5174,480,NA,70,8173,,
SD,Hutchinson,692,2517,112,NA,44,3365,,
SD,Hyde,125,543,17,NA,5,690,,
SD,Jackson,323,722,36,NA,14,1095,,
SD,Jerauld,264,648,36,NA,19,967,,
SD,Jones,69,450,32,NA,7,558,,
SD,Kingsbury,703,1680,139,NA,29,2551,,
SD,Lake,2314,4038,358,NA,76,6786,,
SD,Lawrence,3356,7411,934,NA,141,11842,,
SD,Lincoln,8076,15499,1413,NA,243,25231,,
SD,Lyman,369,977,56,NA,19,1421,,
SD,Marshall,754,1056,117,NA,20,1947,,
SD,McCook,623,1794,130,NA,40,2587,,
SD,McPherson,192,892,43,NA,10,1137,,
SD,Meade,2223,8441,832,NA,125,11621,,
SD,Mellette,238,402,32,NA,11,683,,
SD,Miner,281,706,67,NA,10,1064,,
SD,Minnehaha,30610,42043,4753,NA,857,78263,,
SD,Moody,1042,1729,131,NA,28,2930,,
SD,Oglala Lakota,2504,241,104,NA,47,2896,,
SD,Pennington,14074,29804,3338,NA,525,47741,,
SD,Perkins,188,1333,70,NA,15,1606,,
SD,Potter,215,1069,40,NA,11,1335,,
SD,Roberts,1539,2142,164,NA,41,3886,,
SD,Sanborn,241,819,51,NA,12,1123,,
SD,Spink,919,1854,143,NA,35,2951,,
SD,Stanley,329,1148,77,NA,13,1567,,
SD,Sully,137,679,40,NA,5,861,,
SD,Todd,1505,487,96,NA,37,2125,,
SD,Tripp,462,2069,84,NA,15,2630,,
SD,Turner,961,2937,216,NA,36,4150,,
SD,Union,2227,5288,312,NA,68,7895,,
SD,Walworth,457,1896,79,NA,45,2477,,
SD,Yankton,3301,5654,551,NA,110,9616,,
SD,Ziebach,352,368,28,NA,18,766,,
TN,Anderson,9013,19212,1034,189,433,29881,,
TN,Bedford,3395,11486,306,75,93,15355,,
TN,Benton,1474,4716,83,14,41,6328,,
TN,Bledsoe,897,3622,95,18,32,4664,,
TN,Blount,12100,37443,1666,313,686,52208,,
TN,Bradley,7070,29768,1098,210,520,38666,,
TN,Campbell,2248,9870,251,45,118,12532,,
TN,Cannon,1127,4007,106,29,45,5314,,
TN,Carroll,2327,7756,181,39,81,10384,,
TN,Carter,3453,16898,409,130,194,21084,,
TN,Cheatham,3878,11297,463,99,187,15924,,
TN,Chester,1243,5081,115,10,58,6507,,
TN,Claiborne,1832,8602,192,29,85,10740,,
TN,Clay,707,2141,47,11,14,2920,,
TN,Cocke,1981,9791,211,59,84,12126,,
TN,Coffee,4743,14417,517,113,181,19971,,
TN,Crockett,1303,3982,76,13,23,5397,,
TN,Cumberland,5202,20413,471,99,175,26360,,
TN,Davidson,148864,84550,9603,2459,3592,249068,,
TN,Decatur,894,3588,70,16,24,4592,,
TN,DeKalb,1569,5171,117,49,49,6955,,
TN,Dickson,4722,13233,489,94,161,18699,,
TN,Dyer,2816,10180,193,48,99,13336,,
TN,Fayette,5874,13055,261,62,142,19394,,
TN,Fentress,1100,6038,107,37,51,7333,,
TN,Franklin,4374,11532,319,66,113,16404,,
TN,Gibson,5258,13786,305,66,132,19547,,
TN,Giles,2917,7970,162,41,47,11137,,
TN,Grainger,1154,6626,130,26,72,8008,,
TN,Greene,4216,18562,481,152,172,23583,,
TN,Grundy,999,3636,80,19,29,4763,,
TN,Hamblen,4075,15857,443,93,224,20692,,
TN,Hamilton,55316,78733,5443,1098,1818,142408,,
TN,Hancock,322,1843,42,13,11,2231,,
TN,Hardeman,4185,4919,84,30,55,9273,,
TN,Hardin,1622,8012,134,96,85,9949,,
TN,Hawkins,3507,16648,397,91,131,20774,,
TN,Haywood,3711,3013,60,19,31,6834,,
TN,Henderson,1800,8138,172,39,68,10217,,
TN,Henry,3063,9508,223,60,91,12945,,
TN,Hickman,1824,5695,161,39,94,7813,,
TN,Houston,866,2182,88,12,20,3168,,
TN,Humphreys,1967,4930,166,26,64,7153,,
TN,Jackson,1129,3236,62,17,22,4466,,
TN,Jefferson,3494,14776,497,115,190,19072,,
TN,Johnson,988,5410,102,39,40,6579,,
TN,Knox,62878,105767,7458,1634,2960,180697,,
TN,Lake,577,1357,18,6,12,1970,,
TN,Lauderdale,3056,4884,87,14,46,8087,,
TN,Lawrence,2821,12420,271,77,77,15666,,
TN,Lewis,890,3585,59,42,46,4622,,
TN,Lincoln,2554,10398,231,46,119,13348,,
TN,Loudon,4919,17610,573,87,202,23391,,
TN,Macon,1072,6263,91,36,42,7504,,
TN,Madison,15448,21335,660,140,537,38120,,
TN,Marion,2832,7696,221,50,63,10862,,
TN,Marshall,2852,8184,256,60,103,11455,,
TN,Maury,10038,23799,922,166,444,35369,,
TN,McMinn,3510,14691,340,69,145,18755,,
TN,McNairy,1848,7841,150,110,89,10038,,
TN,Meigs,856,3342,77,19,26,4320,,
TN,Monroe,3186,13374,345,58,130,17093,,
TN,Montgomery,21699,32341,2337,540,703,57620,,
TN,Moore,496,2325,71,17,17,2926,,
TN,Morgan,1054,5441,115,17,78,6705,,
TN,Obion,2426,9526,193,36,68,12249,,
TN,Overton,1945,6059,111,31,83,8229,,
TN,Perry,597,2167,59,23,9,2855,,
TN,Pickett,536,2021,36,7,15,2615,,
TN,Polk,1252,5097,114,26,31,6520,,
TN,Putnam,6851,19002,757,225,377,27212,,
TN,Rhea,1942,8660,221,35,204,11062,,
TN,Roane,4837,15880,596,102,254,21669,,
TN,Robertson,6637,19410,717,161,188,27113,,
TN,Rutherford,36706,64515,3916,894,1405,107436,,
TN,Scott,934,6044,80,21,44,7123,,
TN,Sequatchie,1053,4441,128,25,47,5694,,
TN,Sevier,6297,28629,915,212,259,36312,,
TN,Shelby,208992,116344,6939,1986,3122,337383,,
TN,Smith,1689,5494,171,30,52,7436,,
TN,Stewart,1222,3864,147,21,45,5299,,
TN,Sullivan,12578,46979,1793,355,573,62278,,
TN,Sumner,18161,50129,2102,369,744,71505,,
TN,Tipton,5785,16910,485,90,211,23481,,
TN,Trousdale,946,2103,73,6,32,3160,,
TN,Unicoi,1262,5671,139,53,70,7195,,
TN,Union,1012,5053,108,24,50,6247,,
TN,Van Buren,539,1820,46,8,6,2419,,
TN,Warren,3535,9540,339,61,137,13612,,
TN,Washington,13024,34252,1468,478,528,49750,,
TN,Wayne,717,5036,56,9,39,5857,,
TN,Weakley,2772,9008,220,62,122,12184,,
TN,White,1845,7671,149,45,115,9825,,
TN,Williamson,31013,68212,4518,526,2002,106271,,
TN,Wilson,14385,39406,1807,467,669,56734,,
TX,ANDERSON,3369,13201,308,57,42,16977,,
TX,ANDREWS,836,3927,147,18,15,4943,,
TX,ANGELINA,7538,21668,560,106,39,29911,,
TX,ARANSAS,2465,7740,238,41,28,10512,,
TX,ARCHER,394,3786,80,10,13,4283,,
TX,ARMSTRONG,70,924,18,5,4,1021,,
TX,ATASCOSA,4651,8618,308,65,31,13673,,
TX,AUSTIN,2320,9637,248,51,18,12274,,
TX,BAILEY,397,1344,39,5,8,1793,,
TX,BANDERA,1726,8163,262,66,1,10218,,
TX,BASTROP,10569,16328,1063,320,174,28454,,
TX,BAYLOR,191,1267,31,3,7,1499,,
TX,BEE,3444,4744,238,34,25,8485,,
TX,BELL,37801,51998,3824,812,559,94994,,
TX,BEXAR,319550,240333,20091,6645,3026,589645,,
TX,BLANCO,1244,4212,180,33,16,5685,,
TX,BORDEN,31,330,3,1,0,365,,
TX,BOSQUE,1278,6339,155,40,26,7838,,
TX,BOWIE,8838,24924,582,145,113,34602,,
TX,BRAZORIA,43200,72791,3768,806,616,121181,,
TX,BRAZOS,23121,38738,3813,536,1003,67211,,
TX,BREWSTER,1873,2077,210,77,15,4252,,
TX,BRISCOE,91,625,14,4,2,736,,
TX,BROOKS,1937,613,32,14,0,2596,,
TX,BROWN,1621,12017,253,65,70,14026,,
TX,BURLESON,1491,5316,118,20,15,6960,,
TX,BURNET,3797,14638,564,104,101,19204,,
TX,CALDWELL,4795,6691,446,105,55,12092,,
TX,CALHOUN,2118,4638,168,33,8,6965,,
TX,CALLAHAN,569,4865,107,23,15,5579,,
TX,CAMERON,59402,29472,2236,822,147,92079,,
TX,CAMP,1260,3201,66,15,0,4542,,
TX,CARSON,249,2620,68,11,16,2964,,
TX,CASS,2391,9726,145,34,48,12344,,
TX,CASTRO,526,1414,47,10,0,1997,,
TX,CHAMBERS,2948,13339,385,59,55,16786,,
TX,CHEROKEE,3469,12919,305,34,63,16790,,
TX,CHILDRESS,253,1802,24,5,0,2084,,
TX,CLAY,536,4377,87,12,6,5018,,
TX,COCHRAN,190,679,29,3,0,901,,
TX,COKE,140,1265,16,2,0,1423,,
TX,COLEMAN,388,3177,53,18,7,3643,,
TX,COLLIN,140624,201014,13855,2539,3387,361419,,
TX,COLLINGSWORTH,145,983,22,4,2,1156,,
TX,COLORADO,1987,6325,144,37,20,8513,,
TX,COMAL,14238,45136,2068,343,393,62178,,
TX,COMANCHE,789,4333,88,21,6,5237,,
TX,CONCHO,148,885,27,7,1,1068,,
TX,COOKE,2352,13181,317,60,45,15955,,
TX,CORYELL,5064,12225,704,161,99,18253,,
TX,COTTLE,92,506,12,2,0,612,,
TX,CRANE,299,1049,28,7,1,1384,,
TX,CROCKETT,372,980,39,4,0,1395,,
TX,CROSBY,468,1181,60,5,14,1728,,
TX,CULBERSON,454,280,23,6,4,767,,
TX,DALLAM,222,1261,46,9,6,1544,,
TX,DALLAS,461080,262945,24025,6114,4809,758973,,
TX,DAWSON,835,2636,80,11,1,3563,,
TX,DEAF SMITH,1185,2911,91,14,15,4216,,
TX,DELTA,400,1836,36,7,2,2281,,
TX,DENTON,110890,170603,11583,2660,2909,298645,,
TX,DEWITT,1163,5519,124,27,11,6844,,
TX,DICKENS,128,755,23,3,0,909,,
TX,DIMMIT,2173,974,57,21,0,3225,,
TX,DONLEY,191,1225,40,5,4,1465,,
TX,DUVAL,2783,1316,49,19,1,4168,,
TX,EASTLAND,776,6011,120,31,25,6963,,
TX,ECTOR,10249,25020,1009,167,85,36530,,
TX,EDWARDS,303,746,17,5,2,1073,,
TX,EL PASO,147843,55512,7607,2945,101,214008,,
TX,ELLIS,16253,44941,1747,325,407,63673,,
TX,ERATH,2160,11210,378,68,77,13893,,
TX,FALLS,1684,3441,90,23,10,5248,,
TX,FANNIN,2132,9548,269,46,49,12044,,
TX,FAYETTE,2144,8743,209,45,33,11174,,
TX,FISHER,403,1265,44,10,7,1729,,
TX,FLOYD,435,1474,47,3,0,1959,,
TX,FOARD,113,383,14,1,2,513,,
TX,FORT BEND,134686,117291,6907,1783,1399,262066,,
TX,FRANKLIN,665,3585,96,12,22,4380,,
TX,FREESTONE,1471,6026,139,13,35,7684,,
TX,FRIO,2444,1856,76,24,0,4400,,
TX,GAINES,597,3907,85,20,11,4620,,
TX,GALVESTON,43658,73757,4045,889,554,122903,,
TX,GARZA,230,1225,21,7,1,1484,,
TX,GILLESPIE,2288,10446,333,61,86,13214,,
TX,GLASSCOCK,34,553,13,2,2,604,,
TX,GOLIAD,973,2620,101,10,4,3708,,
TX,GONZALES,1571,4587,129,28,19,6334,,
TX,GRAY,701,6500,144,22,38,7405,,
TX,GRAYSON,10301,35325,1258,264,268,47416,,
TX,GREGG,11677,28764,903,150,255,41749,,
TX,GRIMES,2194,7065,219,50,5,9533,,
TX,GUADALUPE,18391,36632,2022,412,365,57822,,
TX,HALE,2101,6366,324,43,24,8858,,
TX,HALL,164,893,34,0,0,1091,,
TX,HAMILTON,479,3060,64,10,7,3620,,
TX,HANSFORD,171,1730,37,9,0,1947,,
TX,HARDEMAN,249,1207,48,7,2,1513,,
TX,HARDIN,2780,19606,353,41,0,22780,,
TX,HARRIS,707914,545955,39781,11784,6678,1312112,,
TX,HARRISON,7151,18749,449,76,123,26548,,
TX,HARTLEY,173,1730,43,3,3,1952,,
TX,HASKELL,314,1403,42,6,5,1770,,
TX,HAYS,33224,33826,3630,1061,423,72164,,
TX,HEMPHILL,181,1462,44,2,6,1695,,
TX,HENDERSON,5669,23650,535,102,89,30045,,
TX,HIDALGO,118809,48642,3788,1856,342,173437,,
TX,HILL,2547,10108,256,40,19,12970,,
TX,HOCKLEY,1260,5809,199,33,10,7311,,
TX,HOOD,4008,21382,641,113,118,26262,,
TX,HOPKINS,2510,10707,220,44,57,13538,,
TX,HOUSTON,1978,6205,90,29,51,8353,,
TX,HOWARD,1770,6637,232,56,28,8723,,
TX,HUDSPETH,324,503,38,6,0,871,,
TX,HUNT,6396,23910,862,162,224,31554,,
TX,HUTCHINSON,854,7042,210,23,26,8155,,
TX,IRION,90,660,9,1,6,766,,
TX,JACK,314,2973,42,10,11,3350,,
TX,JACKSON,904,4266,78,27,27,5302,,
TX,JASPER,2590,10609,156,38,26,13419,,
TX,JEFF DAVIS,422,695,42,17,15,1191,,
TX,JEFFERSON,42443,42862,1714,420,179,87618,,
TX,JIM HOGG,1635,430,42,12,0,2119,,
TX,JIM WELLS,6694,5420,210,40,15,12379,,
TX,JOHNSON,10988,44382,1605,324,307,57606,,
TX,JONES,936,4819,162,21,22,5960,,
TX,KARNES,1145,2965,70,12,6,4198,,
TX,KAUFMAN,10278,29587,983,197,220,41265,,
TX,KENDALL,3643,15700,555,87,135,20120,,
TX,KENEDY,99,84,3,0,0,186,,
TX,KENT,59,360,14,0,1,434,,
TX,KERR,4681,17727,657,116,116,23297,,
TX,KIMBLE,206,1697,37,5,7,1952,,
TX,KING,5,149,5,0,0,159,,
TX,KINNEY,458,936,25,6,5,1430,,
TX,KLEBERG,4716,4367,314,92,23,9512,,
TX,KNOX,247,1078,28,5,9,1367,,
TX,LAMAR,3583,14561,343,70,54,18611,,
TX,LAMB,771,3111,85,8,20,3995,,
TX,LAMPASAS,1483,6385,253,47,37,8205,,
TX,LASALLE,1129,872,44,10,4,2059,,
TX,LAVACA,1170,7347,112,12,20,8661,,
TX,LEE,1372,4997,126,28,12,6535,,
TX,LEON,909,6391,94,13,32,7439,,
TX,LIBERTY,4862,18892,364,85,64,24267,,
TX,LIMESTONE,1778,5796,128,27,10,7739,,
TX,LIPSCOMB,135,1159,25,3,10,1332,,
TX,LIVE OAK,742,3464,65,13,18,4302,,
TX,LLANO,1825,8299,205,65,53,10447,,
TX,LOVING,4,58,1,2,0,65,,
TX,LUBBOCK,28023,65651,3917,633,789,99013,,
TX,LYNN,403,1546,41,7,12,2009,,
TX,MADISON,881,3351,45,8,4,4289,,
TX,MARION,1165,2983,71,13,6,4238,,
TX,MARTIN,266,1455,31,5,5,1762,,
TX,MASON,354,1656,37,7,3,2057,,
TX,MATAGORDA,3500,8366,239,53,38,12196,,
TX,MAVERICK,10397,2816,266,109,0,13588,,
TX,MCCULLOCH,482,2552,51,9,9,3103,,
TX,MCLENNAN,27063,48260,2492,473,787,79075,,
TX,MCMULLEN,40,454,2,1,2,499,,
TX,MEDINA,4634,12085,403,106,18,17246,,
TX,MENARD,154,682,25,1,2,864,,
TX,MIDLAND,10025,36973,1667,203,344,49212,,
TX,MILAM,2051,6364,178,49,22,8664,,
TX,MILLS,243,1951,41,6,4,2245,,
TX,MITCHELL,354,1780,50,7,5,2196,,
TX,MONTAGUE,885,7526,170,23,0,8604,,
TX,MONTGOMERY,45835,150314,6142,1018,1323,204632,,
TX,MOORE,1098,3977,166,26,17,5284,,
TX,MORRIS,1425,3446,77,19,6,4973,,
TX,MOTLEY,40,566,9,0,0,615,,
TX,NACOGDOCHES,6846,14771,702,159,144,22622,,
TX,NAVARRO,4002,11994,343,58,36,16433,,
TX,NEWTON,1156,4288,66,13,11,5534,,
TX,NOLAN,1029,3552,142,22,112,4857,,
TX,NUECES,49198,50766,3324,847,270,104405,,
TX,OCHILTREE,274,2628,75,5,20,3002,,
TX,OLDHAM,78,850,14,3,3,948,,
TX,ORANGE,5735,25513,550,115,87,32000,,
TX,PALO PINTO,1708,8284,210,48,20,10270,,
TX,PANOLA,1835,8445,109,24,3,10416,,
TX,PARKER,8344,46473,1439,215,346,56817,,
TX,PARMER,485,1915,55,4,7,2466,,
TX,PECOS,1554,2468,127,26,10,4185,,
TX,POLK,4187,15176,367,86,36,19852,,
TX,POTTER,7657,19630,1028,190,146,28651,,
TX,PRESIDIO,1458,652,64,29,5,2208,,
TX,RAINS,628,3968,80,15,10,4701,,
TX,RANDALL,8367,43462,1872,228,376,54305,,
TX,REAGAN,167,709,22,2,4,904,,
TX,REAL,262,1382,28,6,3,1681,,
TX,RED RIVER,1149,3926,67,8,11,5161,,
TX,REEVES,1659,1417,98,10,0,3184,,
TX,REFUGIO,1034,1830,71,10,3,2948,,
TX,ROBERTS,20,524,6,0,4,554,,
TX,ROBERTSON,2203,4668,125,17,22,7035,,
TX,ROCKWALL,9655,28451,1305,207,330,39948,,
TX,RUNNELS,453,3250,60,13,6,3782,,
TX,RUSK,3935,14675,333,51,0,18994,,
TX,SABINE,614,3998,27,9,3,4651,,
TX,SAN AUGUSTINE,910,2622,30,6,1,3569,,
TX,SAN JACINTO,2038,8059,170,52,24,10343,,
TX,SAN PATRICIO,7871,13030,573,113,69,21656,,
TX,SAN SABA,293,2025,32,4,3,2357,,
TX,SCHLEICHER,208,821,24,3,3,1059,,
TX,SCURRY,733,4410,103,22,21,5289,,
TX,SHACKELFORD,103,1378,21,0,2,1504,,
TX,SHELBY,1758,7179,123,21,5,9086,,
TX,SHERMAN,96,807,27,3,2,935,,
TX,SMITH,22300,58930,2076,341,1121,84768,,
TX,SOMERVELL,541,3206,107,23,20,3897,,
TX,STARR,9289,2224,159,68,0,11740,,
TX,STEPHENS,348,3034,65,7,7,3461,,
TX,STERLING,70,549,9,5,0,633,,
TX,STONEWALL,135,555,10,1,0,701,,
TX,SUTTON,313,1075,22,5,1,1416,,
TX,SWISHER,462,1671,51,6,14,2204,,
TX,TARRANT,288392,345921,23775,5413,5013,668514,,
TX,TAYLOR,10085,33250,1763,289,372,45759,,
TX,TERRELL,140,288,10,0,0,438,,
TX,TERRY,753,2459,112,21,10,3355,,
TX,THROCKMORTON,84,715,7,2,0,808,,
TX,TITUS,2597,6511,191,44,76,9419,,
TX,TOM GREEN,9173,27494,1402,218,192,38479,,
TX,TRAVIS,308260,127209,21958,7462,3831,468720,,
TX,TRINITY,1154,4737,80,11,3,5985,,
TX,TYLER,1248,6624,103,22,19,8016,,
TX,UPSHUR,2380,13209,283,59,82,16013,,
TX,UPTON,286,1007,49,3,2,1347,,
TX,UVALDE,3867,4835,191,54,17,8964,,
TX,VAL VERDE,6964,5890,573,131,59,13617,,
TX,VAN ZANDT,2799,18473,385,77,156,21890,,
TX,VICTORIA,8866,21275,782,156,44,31123,,
TX,WALKER,6091,12884,560,161,100,19796,,
TX,WALLER,5748,10531,342,104,59,16784,,
TX,WARD,783,2547,82,10,23,3445,,
TX,WASHINGTON,3382,10945,352,70,79,14828,,
TX,WEBB,42307,12947,1033,591,27,56905,,
TX,WHARTON,4238,10149,269,51,25,14732,,
TX,WHEELER,194,2087,21,4,0,2306,,
TX,WICHITA,8770,27631,1308,256,154,38119,,
TX,WILBARGER,809,3166,115,13,2,4105,,
TX,WILLACY,3422,1547,95,31,0,5095,,
TX,WILLIAMSON,84468,104175,10229,2047,2162,203081,,
TX,WILSON,4790,13998,392,82,170,19432,,
TX,WINKLER,420,1403,49,1,3,1876,,
TX,WISE,3412,20670,505,91,98,24776,,
TX,WOOD,2630,15700,280,64,53,18727,,
TX,YOAKUM,426,1797,73,3,4,2303,,
TX,YOUNG,876,6601,180,19,31,7707,,
TX,ZAPATA,2063,1029,34,16,0,3142,,
TX,ZAVALA,2636,694,50,16,0,3396,,
UT,Beaver,264,1838,36,10,343,2491,,
UT,Box Elder,2282,12230,591,76,4556,19735,,
UT,Cache,8563,21139,1630,330,14495,46157,,
UT,Carbon,1717,5275,191,41,728,7952,,
UT,Daggett,77,331,17,0,49,474,,
UT,Davis,28776,62219,5390,864,41162,138411,,
UT,Duchesne,500,5508,107,18,809,6942,,
UT,Emery,380,3425,71,3,410,4289,,
UT,Garfield,358,1606,61,16,303,2344,,
UT,Grand,1960,1975,180,109,309,4533,,
UT,Iron,2450,11561,540,102,3001,17654,,
UT,Juab,442,2827,72,14,822,4177,,
UT,Kane,741,2265,86,31,382,3505,,
UT,Millard,431,3860,108,6,837,5242,,
UT,Morgan,577,3188,142,11,1274,5192,,
UT,Piute,47,626,11,1,44,729,,
UT,Rich,104,797,21,1,186,1109,,
UT,Salt Lake,175863,138043,16306,4965,83691,418868,,
UT,San Juan,2042,2645,165,47,548,5447,,
UT,Sanpete,1061,6673,186,30,2214,10164,,
UT,Sevier,695,6740,175,29,1015,8654,,
UT,Summit,10503,7333,756,170,1879,20641,,
UT,Tooele,4573,11169,783,182,5122,21829,,
UT,Uintah,995,9810,275,43,1674,12797,,
UT,Utah,28522,102182,6437,1030,63380,201551,,
UT,Wasatch,3063,6115,409,70,2463,12120,,
UT,Washington,10288,42650,1473,290,7262,61963,,
UT,Wayne,271,966,18,12,154,1421,,
UT,Weber,23131,40235,3371,937,17365,85039,,
VA,ACCOMACK COUNTY,6740,8583,264,66,165,15818,,
VA,ALBEMARLE COUNTY,33345,19259,2105,450,1567,56726,,
VA,ALEXANDRIA CITY,57242,13285,2020,592,2623,75762,,
VA,ALLEGHANY COUNTY,2166,4874,164,35,86,7325,,
VA,AMELIA COUNTY,2128,4708,129,11,64,7040,,
VA,AMHERST COUNTY,5057,9719,317,65,238,15396,,
VA,APPOMATTOX COUNTY,2023,5715,136,31,92,7997,,
VA,ARLINGTON COUNTY,92016,20186,3827,819,4491,121339,,
VA,AUGUSTA COUNTY,8177,26163,1099,200,704,36343,,
VA,BATH COUNTY,603,1548,56,15,31,2253,,
VA,BEDFORD COUNTY,9768,30659,1074,176,848,42525,,
VA,BLAND COUNTY,453,2573,61,17,35,3139,,
VA,BOTETOURT COUNTY,4494,13375,497,101,272,18739,,
VA,BRISTOL CITY,1835,4892,136,50,114,7027,,
VA,BRUNSWICK COUNTY,4481,3046,72,25,45,7669,,
VA,BUCHANAN COUNTY,1721,7296,122,24,84,9247,,
VA,BUCKINGHAM COUNTY,3128,3950,102,27,82,7289,,
VA,BUENA VISTA CITY,693,1430,83,13,188,2407,,
VA,CAMPBELL COUNTY,6664,19551,665,102,553,27535,,
VA,CAROLINE COUNTY,6432,7147,368,99,202,14248,,
VA,CARROLL COUNTY,2559,10663,220,69,144,13655,,
VA,CHARLES CITY COUNTY,2496,1476,67,15,53,4107,,
VA,CHARLOTTE COUNTY,2155,3479,111,11,51,5807,,
VA,CHARLOTTESVILLE CITY,17901,2960,785,230,591,22467,,
VA,CHESAPEAKE CITY,52627,54047,3458,698,1832,112662,,
VA,CHESTERFIELD COUNTY,81074,85045,6247,990,3006,176362,,
VA,CLARKE COUNTY,3051,4661,261,55,185,8213,,
VA,COLONIAL HEIGHTS CITY,2367,5681,247,44,118,8457,,
VA,COVINGTON CITY,914,1349,73,8,38,2382,,
VA,CRAIG COUNTY,541,2140,54,20,36,2791,,
VA,CULPEPER COUNTY,7759,13349,584,176,350,22218,,
VA,CUMBERLAND COUNTY,2036,2697,95,24,54,4906,,
VA,DANVILLE CITY,11059,7303,315,73,190,18940,,
VA,DICKENSON COUNTY,1335,4932,81,14,78,6440,,
VA,DINWIDDIE COUNTY,5765,7447,196,46,121,13575,,
VA,EMPORIA CITY,1530,789,26,10,11,2366,,
VA,ESSEX COUNTY,2542,2657,113,18,42,5372,,
VA,FAIRFAX CITY,7367,3702,427,107,425,12028,,
VA,FAIRFAX COUNTY,355133,157710,15664,4477,18199,551183,,
VA,FALLS CHURCH CITY,5819,1324,237,70,307,7757,,
VA,FAUQUIER COUNTY,12971,22127,1191,267,904,37460,,
VA,FLOYD COUNTY,2300,5293,185,107,165,8050,,
VA,FLUVANNA COUNTY,5760,7025,425,80,302,13592,,
VA,FRANKLIN CITY,2519,1421,72,16,33,4061,,
VA,FRANKLIN COUNTY,7257,18569,602,115,428,26971,,
VA,FREDERICK COUNTY,11932,26083,1280,325,820,40440,,
VA,FREDERICKSBURG CITY,6707,3744,389,137,280,11257,,
VA,GALAX CITY,681,1603,45,7,40,2376,,
VA,GILES COUNTY,1950,5910,201,39,112,8212,,
VA,GLOUCESTER COUNTY,5404,13096,693,134,292,19619,,
VA,GOOCHLAND COUNTY,4889,8384,474,54,236,14037,,
VA,GRAYSON COUNTY,1407,5592,110,55,121,7285,,
VA,GREENE COUNTY,2924,5945,406,66,266,9607,,
VA,GREENSVILLE COUNTY,2558,1737,50,6,12,4363,,
VA,HALIFAX COUNTY,6897,9704,237,44,112,16994,,
VA,HAMPTON CITY,41312,17902,1658,474,931,62277,,
VA,HANOVER COUNTY,19382,39630,2310,314,1087,62723,,
VA,HARRISONBURG CITY,10212,6262,810,255,448,17987,,
VA,HENRICO COUNTY,93935,59857,5657,1081,3006,163536,,
VA,HENRY COUNTY,8198,15208,378,98,209,24091,,
VA,HIGHLAND COUNTY,371,958,33,8,21,1391,,
VA,HOPEWELL CITY,4724,3885,212,58,129,9008,,
VA,ISLE OF WIGHT COUNTY,7881,12204,589,81,320,21075,,
VA,JAMES CITY COUNTY,19105,21306,1395,281,1082,43169,,
VA,KING & QUEEN COUNTY,1468,2099,75,18,30,3690,,
VA,KING GEORGE COUNTY,4007,7341,367,83,252,12050,,
VA,KING WILLIAM COUNTY,2760,5975,261,44,106,9146,,
VA,LANCASTER COUNTY,2869,3523,141,35,77,6645,,
VA,LEE COUNTY,1627,7543,106,33,90,9399,,
VA,LEXINGTON CITY,1514,766,92,20,73,2465,,
VA,LOUDOUN COUNTY,100795,69949,5674,1316,5316,183050,,
VA,LOUISA COUNTY,6212,10528,505,124,243,17612,,
VA,LUNENBURG COUNTY,2227,3204,88,25,42,5586,,
VA,LYNCHBURG CITY,14792,17982,1379,208,1296,35657,,
VA,MADISON COUNTY,2203,4419,184,43,130,6979,,
VA,MANASSAS CITY,8423,5953,488,147,400,15411,,
VA,MANASSAS PARK CITY,3204,1733,162,45,88,5232,,
VA,MARTINSVILLE CITY,3533,2149,114,29,82,5907,,
VA,MATHEWS COUNTY,1563,3517,147,31,53,5311,,
VA,MECKLENBURG COUNTY,6285,8288,239,30,103,14945,,
VA,MIDDLESEX COUNTY,2108,3670,140,33,66,6017,,
VA,MONTGOMERY COUNTY,20021,19459,2026,401,1124,43031,,
VA,NELSON COUNTY,3689,4154,244,81,143,8311,,
VA,NEW KENT COUNTY,3546,8118,348,52,169,12233,,
VA,NEWPORT NEWS CITY,45618,25468,2531,591,1429,75637,,
VA,NORFOLK CITY,57023,21552,2717,797,1296,83385,,
VA,NORTHAMPTON COUNTY,3255,2686,116,40,71,6168,,
VA,NORTHUMBERLAND COUNTY,2852,4302,136,21,86,7397,,
VA,NORTON CITY,383,1021,24,6,26,1460,,
VA,NOTTOWAY COUNTY,2829,3712,116,25,62,6744,,
VA,ORANGE COUNTY,5957,10521,399,116,274,17267,,
VA,PAGE COUNTY,2514,7831,198,38,159,10740,,
VA,PATRICK COUNTY,1768,6454,147,49,107,8525,,
VA,PETERSBURG CITY,12021,1451,139,67,108,13786,,
VA,PITTSYLVANIA COUNTY,9199,21554,442,106,297,31598,,
VA,POQUOSON CITY,1601,5092,307,43,134,7177,,
VA,PORTSMOUTH CITY,28497,12795,1096,323,550,43261,,
VA,POWHATAN COUNTY,4060,11885,639,73,231,16888,,
VA,PRINCE EDWARD COUNTY,4591,4101,286,53,112,9143,,
VA,PRINCE GEORGE COUNTY,6419,9157,374,70,164,16184,,
VA,PRINCE WILLIAM COUNTY,113144,71721,5374,1497,4706,196442,,
VA,PULASKI COUNTY,4172,10322,351,107,213,15165,,
VA,RADFORD CITY,2925,2638,301,58,160,6082,,
VA,RAPPAHANNOCK COUNTY,1747,2539,93,36,68,4483,,
VA,RICHMOND CITY,81259,15581,3617,1134,1815,103406,,
VA,RICHMOND COUNTY,1347,2213,57,13,31,3661,,
VA,ROANOKE CITY,22286,14789,1316,411,664,39466,,
VA,ROANOKE COUNTY,17200,31408,1620,286,975,51489,,
VA,ROCKBRIDGE COUNTY,3508,6680,271,66,270,10795,,
VA,ROCKINGHAM COUNTY,9366,25990,1088,208,835,37487,,
VA,RUSSELL COUNTY,2330,9521,190,58,147,12246,,
VA,SALEM CITY,4202,7226,442,92,263,12225,,
VA,SCOTT COUNTY,1581,8247,142,39,91,10100,,
VA,SHENANDOAH COUNTY,5273,14094,556,149,436,20508,,
VA,SMYTH COUNTY,2665,9750,258,53,164,12890,,
VA,SOUTHAMPTON COUNTY,3595,5035,156,24,62,8872,,
VA,SPOTSYLVANIA COUNTY,24207,34623,1910,450,1359,62549,,
VA,STAFFORD COUNTY,27908,33868,2140,488,1530,65934,,
VA,STAUNTON CITY,5333,5133,419,109,261,11255,,
VA,SUFFOLK CITY,23280,18006,1098,223,633,43240,,
VA,SURRY COUNTY,2272,1819,81,17,39,4228,,
VA,SUSSEX COUNTY,2879,2055,63,22,25,5044,,
VA,TAZEWELL COUNTY,2895,15168,260,53,190,18566,,
VA,VIRGINIA BEACH CITY,91032,98224,8255,1737,3771,203019,,
VA,WARREN COUNTY,5169,11773,495,149,365,17951,,
VA,WASHINGTON COUNTY,5553,19320,537,93,343,25846,,
VA,WAYNESBORO CITY,3764,4801,336,74,229,9204,,
VA,WESTMORELAND COUNTY,3836,4448,157,40,93,8574,,
VA,WILLIAMSBURG CITY,5206,1925,231,84,180,7626,,
VA,WINCHESTER CITY,5164,4790,400,99,212,10665,,
VA,WISE COUNTY,2701,12086,182,77,117,15163,,
VA,WYTHE COUNTY,2770,10046,285,49,178,13328,,
VA,YORK COUNTY,12999,18837,1186,252,839,34113,,
VT,ADDISON,324,337,47,8,59,775,,
VT,ALBANY,207,183,13,9,38,450,,
VT,ALBURGH,372,399,29,8,80,888,,
VT,ANDOVER,166,125,8,4,27,330,,
VT,ARLINGTON,662,435,28,22,121,1268,,
VT,ATHENS,69,61,6,8,22,166,,
VT,BAKERSFIELD,295,209,22,10,61,597,,
VT,BALTIMORE,50,60,9,2,5,126,,
VT,BARNARD,339,174,13,11,32,569,,
VT,BARNET,485,355,46,21,54,961,,
VT,BARRE CITY,1653,1091,109,66,297,3216,,
VT,BARRE TOWN,1760,1862,139,55,352,4168,,
VT,BARTON,502,425,32,5,105,1069,,
VT,BELVIDERE,53,85,7,1,12,158,,
VT,BENNINGTON,3361,1949,155,147,413,6025,,
VT,BENSON,216,232,23,10,27,508,,
VT,BERKSHIRE,209,308,26,5,61,609,,
VT,BERLIN,658,454,51,31,162,1356,,
VT,BETHEL,543,299,33,36,86,997,,
VT,BLOOMFIELD,30,52,8,6,14,110,,
VT,BOLTON,389,205,14,8,58,674,,
VT,BRADFORD,624,409,42,23,98,1196,,
VT,BRAINTREE,289,217,21,9,57,593,,
VT,BRANDON,924,723,49,33,142,1871,,
VT,BRATTLEBORO,4347,859,95,236,400,5937,,
VT,BRIDGEWATER,280,160,11,13,58,522,,
VT,BRIDPORT,292,278,24,8,53,655,,
VT,BRIGHTON,229,276,17,8,30,560,,
VT,BRISTOL,1075,558,60,41,192,1926,,
VT,BROOKFIELD,378,231,34,26,80,749,,
VT,BROOKLINE,169,68,12,6,32,287,,
VT,BROWNINGTON,146,193,8,2,42,391,,
VT,BRUNSWICK,21,28,2,0,5,56,,
VT,BURKE,381,336,34,13,59,823,,
VT,BURLINGTON,14519,2082,412,689,1236,18938,,
VT,CABOT,394,252,37,32,78,793,,
VT,CALAIS,688,195,21,42,74,1020,,
VT,CAMBRIDGE,1067,520,89,41,211,1928,,
VT,CANAAN,179,207,12,2,30,430,,
VT,CASTLETON,795,808,39,22,127,1791,,
VT,CAVENDISH,306,262,20,19,79,686,,
VT,CHARLESTON,184,210,17,13,40,464,,
VT,CHARLOTTE,1794,512,79,54,125,2564,,
VT,CHELSEA,304,273,22,12,49,660,,
VT,CHESTER,827,512,47,34,126,1546,,
VT,CHITTENDEN,352,312,21,11,55,751,,
VT,CLARENDON,470,641,35,11,85,1242,,
VT,COLCHESTER,4483,2425,245,120,490,7763,,
VT,CONCORD,181,292,30,3,58,564,,
VT,CORINTH,308,264,19,14,72,677,,
VT,CORNWALL,517,147,22,14,37,737,,
VT,COVENTRY,196,244,16,5,49,510,,
VT,CRAFTSBURY,435,153,26,25,48,687,,
VT,DANBY,252,291,39,15,44,641,,
VT,DANVILLE,645,494,50,22,98,1309,,
VT,DERBY,885,1004,82,36,175,2182,,
VT,DORSET,740,334,36,18,61,1189,,
VT,DOVER,409,279,24,14,57,783,,
VT,DUMMERSTON,797,213,31,27,86,1154,,
VT,DUXBURY,434,196,38,18,99,785,,
VT,EAST HAVEN,51,70,2,6,17,146,,
VT,EAST MONTPELIER,1032,356,41,62,119,1610,,
VT,EDEN,221,241,17,18,64,561,,
VT,ELMORE,339,132,19,16,35,541,,
VT,ENOSBURGH,502,429,57,22,185,1195,,
VT,ESSEX,6753,3030,418,155,853,11209,,
VT,FAIR HAVEN,478,529,23,17,102,1149,,
VT,FAIRFAX,1063,947,113,42,200,2365,,
VT,FAIRFIELD,489,338,41,12,64,944,,
VT,FAIRLEE,350,149,17,11,39,566,,
VT,FAYSTON,586,142,21,23,51,823,,
VT,FERRISBURGH,892,501,61,21,132,1607,,
VT,FLETCHER,336,240,31,23,71,701,,
VT,FRANKLIN,229,296,33,4,66,628,,
VT,GEORGIA,1019,1023,90,38,227,2397,,
VT,GLOVER,290,193,31,15,56,585,,
VT,GOSHEN,78,31,6,3,5,123,,
VT,GRAFTON,210,131,14,6,29,390,,
VT,GRANBY,12,22,1,3,3,41,,
VT,GRAND ISLE,594,431,39,13,97,1174,,
VT,GRANVILLE,82,29,3,6,28,148,,
VT,GREENSBORO,271,96,12,11,36,426,,
VT,GROTON,159,234,18,16,56,483,,
VT,GUILDHALL,40,76,10,3,15,144,,
VT,GUILFORD,719,274,29,44,99,1165,,
VT,HALIFAX,202,183,10,12,26,433,,
VT,HANCOCK,75,54,6,4,20,159,,
VT,HARDWICK,651,501,42,49,133,1376,,
VT,HARTFORD,3190,1303,174,93,377,5137,,
VT,HARTLAND,1158,558,52,38,118,1924,,
VT,HIGHGATE,474,699,42,11,160,1386,,
VT,HINESBURG,1726,623,81,57,177,2664,,
VT,HOLLAND,81,175,10,2,34,302,,
VT,HUBBARDTON,188,163,12,6,20,389,,
VT,HUNTINGTON,796,232,44,35,132,1239,,
VT,HYDE PARK,788,475,48,37,183,1531,,
VT,IRA,102,103,8,19,12,244,,
VT,IRASBURG,194,284,27,2,47,554,,
VT,ISLE LA MOTTE,136,140,12,5,14,307,,
VT,JAMAICA,311,132,24,11,35,513,,
VT,JAY,113,101,6,3,22,245,,
VT,JERICHO,2017,890,101,54,263,3325,,
VT,JOHNSON,691,395,45,48,143,1322,,
VT,KILLINGTON,357,232,29,10,33,661,,
VT,KIRBY,125,96,6,8,28,263,,
VT,LANDGROVE,71,18,5,1,8,103,,
VT,LEICESTER,217,207,15,5,48,492,,
VT,LEMINGTON,18,28,6,1,2,55,,
VT,LINCOLN,494,188,22,27,60,791,,
VT,LONDONDERRY,517,303,30,27,65,942,,
VT,LOWELL,123,250,11,4,45,433,,
VT,LUDLOW,538,403,28,23,98,1090,,
VT,LUNENBURG,171,311,20,9,42,553,,
VT,LYNDON,827,883,86,43,223,2062,,
VT,MAIDSTONE,39,60,6,1,11,117,,
VT,MANCHESTER,1452,706,74,33,128,2393,,
VT,MARLBORO,432,90,5,21,27,575,,
VT,MARSHFIELD,417,284,27,51,85,864,,
VT,MENDON,302,268,26,10,32,638,,
VT,MIDDLEBURY,2682,595,77,71,242,3667,,
VT,MIDDLESEX,719,228,31,47,86,1111,,
VT,MIDDLETOWN SPRINGS,233,179,8,18,46,484,,
VT,MILTON,2260,2085,149,70,506,5070,,
VT,MONKTON,671,360,57,16,98,1202,,
VT,MONTGOMERY,302,231,21,19,85,658,,
VT,MONTPELIER,3698,492,98,208,275,4771,,
VT,MORETOWN,649,216,42,22,91,1020,,
VT,MORGAN,101,197,10,2,27,337,,
VT,MORRISTOWN,1550,741,81,89,246,2707,,
VT,MOUNT HOLLY,337,325,25,15,62,764,,
VT,MOUNT TABOR,45,42,5,0,3,95,,
VT,NEW HAVEN,594,337,45,21,81,1078,,
VT,NEWARK,130,116,16,13,26,301,,
VT,NEWBURY,528,403,28,21,84,1064,,
VT,NEWFANE,652,209,14,42,75,992,,
VT,NEWPORT CITY,721,614,34,19,155,1543,,
VT,NEWPORT TOWN,256,338,31,16,62,703,,
VT,NORTH HERO,320,216,15,6,64,621,,
VT,NORTHFIELD,1113,708,105,49,172,2147,,
VT,NORTON,30,46,4,0,4,84,,
VT,NORWICH,1982,191,36,33,79,2321,,
VT,ORANGE,186,265,22,17,48,538,,
VT,ORWELL,270,284,29,16,49,648,,
VT,PANTON,171,126,6,6,29,338,,
VT,PAWLET,368,311,23,9,43,754,,
VT,PEACHAM,291,113,25,11,32,472,,
VT,PERU,166,54,4,2,5,231,,
VT,PITTSFIELD,147,114,8,5,20,294,,
VT,PITTSFORD,668,669,65,19,106,1527,,
VT,PLAINFIELD,424,129,16,42,65,676,,
VT,PLYMOUTH,173,125,13,9,28,348,,
VT,POMFRET,395,130,21,7,39,592,,
VT,POULTNEY,652,599,49,37,103,1440,,
VT,POWNAL,761,681,47,29,110,1628,,
VT,PROCTOR,385,339,34,12,74,844,,
VT,PUTNEY,992,175,32,40,72,1311,,
VT,RANDOLPH,1160,737,78,67,212,2254,,
VT,READING,231,108,11,7,16,373,,
VT,READSBORO,166,173,7,7,26,379,,
VT,RICHFORD,324,388,21,15,79,827,,
VT,RICHMOND,1694,515,100,49,166,2524,,
VT,RIPTON,228,58,5,13,31,335,,
VT,ROCHESTER,393,162,17,17,54,643,,
VT,ROCKINGHAM,1315,576,75,46,143,2155,,
VT,ROXBURY,186,118,21,14,36,375,,
VT,ROYALTON,698,406,46,31,136,1317,,
VT,RUPERT,213,138,14,6,20,391,,
VT,RUTLAND CITY,3495,2734,209,109,550,7097,,
VT,RUTLAND TOWN,1064,979,88,19,148,2298,,
VT,RYEGATE,252,239,15,12,19,537,,
VT,SAINT ALBANS CITY,1287,807,120,43,248,2505,,
VT,SAINT ALBANS TOWN,1416,1268,106,32,292,3114,,
VT,SAINT GEORGE,200,110,7,6,35,358,,
VT,SAINT JOHNSBURY,1469,1110,125,64,242,3010,,
VT,SALISBURY,296,189,8,9,53,555,,
VT,SANDGATE,99,95,6,7,10,217,,
VT,SEARSBURG,19,36,0,0,3,58,,
VT,SHAFTSBURY,952,661,53,26,122,1814,,
VT,SHARON,428,217,15,25,70,755,,
VT,SHEFFIELD,110,131,14,6,42,303,,
VT,SHELBURNE,3390,941,111,79,265,4786,,
VT,SHELDON,305,377,31,11,91,815,,
VT,SHOREHAM,356,211,19,13,51,650,,
VT,SHREWSBURY,325,269,16,9,42,661,,
VT,SOUTH BURLINGTON,7246,2059,322,196,577,10400,,
VT,SOUTH HERO,672,301,36,18,93,1120,,
VT,SPRINGFIELD,1873,1510,144,85,341,3953,,
VT,STAMFORD,203,238,16,6,11,474,,
VT,STANNARD,58,22,5,1,14,100,,
VT,STARKSBORO,534,256,36,24,81,931,,
VT,STOCKBRIDGE,222,140,7,13,44,426,,
VT,STOWE,1974,559,113,39,156,2841,,
VT,STRAFFORD,500,105,24,30,34,693,,
VT,STRATTON,65,50,2,0,9,126,,
VT,SUDBURY,163,122,12,3,19,319,,
VT,SUNDERLAND,281,183,12,6,35,517,,
VT,SUTTON,168,220,24,11,3,426,,
VT,SWANTON,1101,1192,82,33,262,2670,,
VT,THETFORD,1145,324,45,34,97,1645,,
VT,TINMOUTH,139,123,15,3,16,296,,
VT,TOPSHAM,226,274,19,8,47,574,,
VT,TOWNSHEND,412,174,17,10,69,682,,
VT,TROY,243,283,19,10,91,646,,
VT,TUNBRIDGE,349,242,21,22,68,702,,
VT,UNDERHILL,1238,504,55,26,141,1964,,
VT,VERGENNES,712,326,51,23,107,1219,,
VT,VERNON,492,486,50,11,83,1122,,
VT,VERSHIRE,189,118,10,18,29,364,,
VT,VICTORY,18,38,3,1,5,65,,
VT,WAITSFIELD,751,210,29,35,86,1111,,
VT,WALDEN,246,168,22,25,58,519,,
VT,WALLINGFORD,529,463,35,22,64,1113,,
VT,WALTHAM,149,83,14,2,27,275,,
VT,WARDSBORO,199,137,12,11,33,392,,
VT,WARREN,752,182,45,25,75,1079,,
VT,WASHINGTON,217,241,24,11,43,536,,
VT,WATERBURY,2035,592,91,44,278,3040,,
VT,WATERFORD,292,341,37,5,61,736,,
VT,WATERVILLE,161,146,14,10,44,375,,
VT,WEATHERSFIELD,745,647,51,26,108,1577,,
VT,WELLS,209,312,17,6,31,575,,
VT,WEST FAIRLEE,161,97,15,2,22,297,,
VT,WEST HAVEN,56,56,0,7,14,133,,
VT,WEST RUTLAND,384,541,33,10,72,1040,,
VT,WEST WINDSOR,469,173,27,6,32,707,,
VT,WESTFIELD,134,123,6,11,30,304,,
VT,WESTFORD,696,371,58,22,122,1269,,
VT,WESTMINSTER,1001,352,32,61,100,1546,,
VT,WESTMORE,103,93,7,4,9,216,,
VT,WESTON,267,106,8,5,28,414,,
VT,WEYBRIDGE,415,74,18,8,8,523,,
VT,WHEELOCK,156,175,13,13,37,394,,
VT,WHITING,95,68,8,2,24,197,,
VT,WHITINGHAM,283,285,22,10,42,642,,
VT,WILLIAMSTOWN,627,658,72,25,159,1541,,
VT,WILLISTON,3508,1481,195,69,349,5602,,
VT,WILMINGTON,591,338,36,26,55,1046,,
VT,WINDHAM,156,79,10,8,23,276,,
VT,WINDSOR,964,462,92,44,133,1695,,
VT,WINHALL,299,158,15,7,38,517,,
VT,WINOOSKI,2105,536,78,107,243,3069,,
VT,WOLCOTT,397,276,24,27,74,798,,
VT,WOODBURY,271,169,18,18,51,527,,
VT,WOODFORD,94,66,6,1,10,177,,
VT,WOODSTOCK,1319,372,48,31,110,1880,,
VT,WORCESTER,374,117,19,27,57,594,,
WA,Adams,1299,3083,183,22,57,4644,,
WA,Asotin,3134,5741,624,117,120,9736,,
WA,Benton,26360,47194,4819,874,780,80027,,
WA,Chelan,13032,18114,1504,480,250,33380,,
WA,Clallam,17677,18794,1838,810,338,39457,,
WA,Clark,92757,92441,10076,3344,1542,200160,,
WA,Columbia,526,1497,109,26,24,2182,,
WA,Cowlitz,17908,24185,2343,787,469,45692,,
WA,Douglas,4918,9603,714,185,123,15543,,
WA,Ferry,1098,2202,191,58,52,3601,,
WA,Franklin,8886,13206,1148,225,255,23720,,
WA,Garfield,279,851,88,14,14,1246,,
WA,Grant,7810,18518,1387,291,340,28346,,
WA,Grays Harbor,12020,14067,1443,568,269,28367,,
WA,Island,20960,18465,2319,807,325,42876,,
WA,Jefferson,12656,6037,746,706,131,20276,,
WA,King,718322,216339,40861,17704,5273,998499,,
WA,Kitsap,63156,49018,8596,2397,1150,124317,,
WA,Kittitas,7489,10100,908,315,143,18955,,
WA,Klickitat,4194,5789,463,217,106,10769,,
WA,Lewis,9654,21992,1664,514,325,34149,,
WA,Lincoln,1244,4108,252,50,59,5713,,
WA,Mason,11993,13677,1560,556,287,28073,,
WA,Okanogan,6298,9610,713,291,179,17091,,
WA,Pacific,4620,5360,436,200,100,10716,,
WA,Pend Oreille,1934,4373,323,99,73,6802,,
WA,Pierce,172538,146824,19909,6144,3070,348485,,
WA,San Juan,7172,2688,402,467,45,10774,,
WA,Skagit,26690,24736,3090,1006,446,55968,,
WA,Skamania,2232,2928,285,139,55,5639,,
WA,Snohomish,185227,128255,19347,6396,2948,342173,,
WA,Spokane,93767,113435,13227,4185,2632,227246,,
WA,Stevens,5767,15161,1134,307,308,22677,,
WA,Thurston,68798,48624,7306,3584,1098,129410,,
WA,Wahkiakum,832,1344,111,50,21,2358,,
WA,Walla Walla,9694,13651,1435,386,253,25419,,
WA,Whatcom,60340,40599,4837,3005,892,109673,,
WA,Whitman,8146,7403,1227,317,212,17305,,
WA,Yakima,31291,41735,3261,774,689,77750,,
WI,ADAMS,3770,5983,207,80,72,10112,,
WI,ASHLAND,4228,3302,192,167,54,7943,,
WI,BARRON,7879,13606,727,169,190,22571,,
WI,BAYFIELD,4954,4125,197,185,64,9525,,
WI,BROWN,53364,67199,4984,1371,884,127802,,
WI,BUFFALO,2531,4049,218,74,58,6930,,
WI,BURNETT,2948,5412,236,67,80,8743,,
WI,CALUMET,9646,15348,1053,204,301,26552,,
WI,CHIPPEWA,11886,17909,1220,264,282,31561,,
WI,CLARK,4227,8646,455,109,159,13596,,
WI,COLUMBIA,13526,14160,1092,347,264,29389,,
WI,CRAWFORD,3425,3844,277,73,82,7701,,
WI,DANE,217526,71279,10544,4314,1987,305650,,
WI,DODGE,13968,26643,1539,361,554,43065,,
WI,DOOR,8026,8584,558,145,143,17456,,
WI,DOUGLAS,11345,9659,723,337,165,22229,,
WI,DUNN,9026,11488,1094,294,189,22091,,
WI,EAU CLAIRE,27294,23311,2496,699,554,54354,,
WI,FLORENCE,666,1897,64,17,13,2657,,
WI,FOND DU LAC,17391,31044,1910,449,533,51327,,
WI,FOREST,1584,2788,80,37,24,4513,,
WI,GRANT,10046,12349,1159,308,237,24099,,
WI,GREEN,9122,8693,687,196,131,18829,,
WI,GREEN LAKE,2701,6213,274,75,91,9354,,
WI,IOWA,6669,4809,456,115,82,12131,,
WI,IRON,1273,2090,72,34,11,3480,,
WI,JACKSON,3821,4907,300,108,89,9225,,
WI,JEFFERSON,16561,23410,1660,462,493,42586,,
WI,JUNEAU,4073,7123,280,105,81,11662,,
WI,KENOSHA,35771,36025,2719,861,644,76020,,
WI,KEWAUNEE,3623,6616,348,79,92,10758,,
WI,LA CROSSE,32406,26389,2673,920,580,62968,,
WI,LAFAYETTE,3288,3977,238,49,66,7618,,
WI,LANGLADE,3260,6436,279,67,59,10101,,
WI,LINCOLN,5370,8400,596,114,84,14564,,
WI,MANITOWOC,14506,23193,1558,346,420,40023,,
WI,MARATHON,26477,39013,2330,641,523,68984,,
WI,MARINETTE,6243,12995,520,131,157,20046,,
WI,MARQUETTE,2809,4714,187,50,88,7848,,
WI,MENOMINEE,1003,269,0,7,0,1279,,
WI,MILWAUKEE,288797,125846,13590,4529,3136,435898,,
WI,MONROE,7048,11352,701,230,191,19522,,
WI,OCONTO,5884,13253,581,118,142,19978,,
WI,ONEIDA,8104,11677,751,191,170,20893,,
WI,OUTAGAMIE,38087,49884,3931,985,981,93868,,
WI,OZAUKEE,20168,30430,2110,387,731,53826,,
WI,PEPIN,1345,2206,115,33,40,3739,,
WI,PIERCE,8382,11258,1044,281,189,21154,,
WI,POLK,7570,13815,886,232,168,22671,,
WI,PORTAGE,18521,17306,1490,583,304,38204,,
WI,PRICE,2669,4562,200,84,62,7577,,
WI,RACINE,42512,46611,3248,834,928,94133,,
WI,RICHLAND,3577,4023,242,107,70,8019,,
WI,ROCK,39343,31488,2859,885,586,75161,,
WI,RUSK,2171,4564,197,63,71,7066,,
WI,SAUK,14692,14791,1106,424,305,31318,,
WI,SAWYER,3504,5185,210,99,41,9039,,
WI,SHAWANO,6056,12742,608,172,173,19751,,
WI,SHEBOYGAN,22956,32458,2376,544,775,59109,,
WI,ST. CROIX,17486,26220,2338,513,518,47075,,
WI,TAYLOR,2398,6589,293,69,90,9439,,
WI,TREMPEALEAU,5636,7364,384,117,109,13610,,
WI,VERNON,6352,6996,447,290,128,14213,,
WI,VILAS,4770,8169,340,116,74,13469,,
WI,WALWORTH,18706,28851,2118,612,562,50849,,
WI,WASHBURN,3284,5404,271,64,68,9091,,
WI,WASHINGTON,20855,51729,2745,548,821,76698,,
WI,WAUKESHA,79200,142521,8891,1674,2437,234723,,
WI,WAUPACA,8440,16189,800,240,198,25867,,
WI,WAUSHARA,3792,7669,326,96,116,11999,,
WI,WINNEBAGO,37054,43448,3820,1063,825,86210,,
WI,WOOD,14232,21503,1365,392,308,37800,,
WV,Barbour,1222,4527,214,64,27,6054,,
WV,Berkeley,12321,28244,1623,473,189,42850,,
WV,Boone,1790,6504,246,70,73,8683,,
WV,Braxton,1321,3537,157,47,28,5090,,
WV,Brooke,2568,6625,297,99,24,9613,,
WV,Cabell,11447,19850,1209,397,182,33085,,
WV,Calhoun,456,2035,63,45,18,2617,,
WV,Clay,568,2300,60,25,19,2972,,
WV,Doddridge,362,2358,65,37,18,2840,,
WV,Fayette,4290,10357,443,180,67,15337,,
WV,Gilmer,545,1896,68,24,10,2543,,
WV,Grant,512,4346,65,21,12,4956,,
WV,Greenbrier,3765,9556,475,200,70,14066,,
WV,Hampshire,1580,6692,196,103,37,8608,,
WV,Hancock,3262,8909,370,125,36,12702,,
WV,Hardy,1155,4274,140,42,32,5643,,
WV,Harrison,7694,18750,1041,327,148,27960,,
WV,Jackson,2663,9020,305,106,93,12187,,
WV,Jefferson,9518,13204,1005,333,87,24147,,
WV,Kanawha,28263,43850,2494,814,269,75690,,
WV,Lewis,1347,5274,209,69,29,6928,,
WV,Lincoln,1459,5307,191,62,47,7066,,
WV,Logan,2092,9897,237,85,48,12359,,
WV,Marion,6964,14668,899,367,131,23029,,
WV,Marshall,2918,9666,418,153,61,13216,,
WV,Mason,2081,7654,276,86,89,10186,,
WV,McDowell,1438,4629,90,27,19,6203,,
WV,Mercer,4704,17404,552,209,113,22982,,
WV,Mineral,2050,9070,282,123,39,11564,,
WV,Mingo,1370,7911,145,32,52,9510,,
WV,Monongalia,14699,18432,1827,815,275,36048,,
WV,Monroe,1111,4443,149,57,45,5805,,
WV,Morgan,1573,5732,208,103,38,7654,,
WV,Nicholas,1840,7251,283,83,34,9491,,
WV,Ohio,5493,11139,748,384,174,17938,,
WV,Pendleton,729,2398,73,18,7,3225,,
WV,Pleasants,621,2358,123,20,28,3150,,
WV,Pocahontas,928,2496,150,57,15,3646,,
WV,Preston,2470,9538,429,131,91,12659,,
WV,Putnam,5884,17788,823,265,133,24893,,
WV,Raleigh,6443,22048,687,252,188,29618,,
WV,Randolph,2735,7629,339,95,78,10876,,
WV,Ritchie,496,3405,105,40,29,4075,,
WV,Roane,1222,3781,143,65,36,5247,,
WV,Summers,1190,3455,137,57,23,4862,,
WV,Taylor,1491,4733,194,77,43,6538,,
WV,Tucker,751,2565,103,46,10,3475,,
WV,Tyler,507,2996,103,25,23,3654,,
WV,Upshur,1766,7005,310,89,48,9218,,
WV,Wayne,3357,11152,421,122,130,15182,,
WV,Webster,556,2302,82,30,8,2978,,
WV,Wetzel,1359,4519,245,66,76,6265,,
WV,Wirt,386,1911,84,24,17,2422,,
WV,Wood,8400,25434,1266,371,144,35615,,
WV,Wyoming,1062,6547,137,38,47,7831,,
WY,Albany,6890,7602,1391,344,1018,17245,,
WY,Big Horn,604,4067,242,35,458,5406,,
WY,Campbell,1324,15778,653,66,530,18351,,
WY,Carbon,1279,4409,381,49,343,6461,,
WY,Converse,668,5520,251,42,225,6706,,
WY,Crook,273,3348,118,11,116,3866,,
WY,Fremont,4200,11167,773,233,868,17241,,
WY,Goshen,924,4418,234,45,259,5880,,
WY,Hot Springs,400,1939,136,35,134,2644,,
WY,Johnson,638,3477,174,33,150,4472,,
WY,Laramie,11573,24847,2657,434,1842,41353,,
WY,Lincoln,1105,6779,331,48,707,8970,,
WY,Natrona,6577,23552,1791,310,1487,33717,,
WY,Niobrara,115,1116,49,7,44,1331,,
WY,Park,2535,11115,625,151,885,15311,,
WY,Platte,719,3437,180,36,208,4580,,
WY,Sheridan,2927,10266,729,158,621,14701,,
WY,Sublette,644,3409,169,28,192,4442,,
WY,Sweetwater,3231,12154,928,152,844,17309,,
WY,Teton,7314,3921,701,172,687,12795,,
WY,Uinta,1202,6154,472,79,663,8570,,
WY,Washakie,532,2911,194,37,191,3865,,
WY,Weston,299,3033,108,10,122,3572,,
